File,Result,D_B,D_C,D_L,D_R,D_S,D_E(%),nNodes,nEdges,nSegRelEdges,dPairs,segPairErrors,nodeCorrect,edgeDiffClassCount,undirDiffClassCount,nSeg,detectedSeg,dSegRelEdges,CorrectSegments,CorrectSegmentsAndClass,ClassError,CorrectSegRels,CorrectSegRelLocations,SegRelErrors,hasCorrectSegments,hasCorrectSegLab,hasCorrectRelationLocations,hasCorrectRelLab,hasCorrectStructure
./data/output_files/out/UN_101_em_0.lg, Incorrect,17,2,15,15,0,0.183697551585,11,110,7,15,0,9,0,0,8,8,0,8,6,2,0,0,0,1,0,0,0,0
./data/output_files/out/UN_101_em_1.lg, Incorrect,17,2,15,13,2,0.281774784492,9,72,5,14,1,0,0,0,6,6,0,5,5,1,0,0,0,0,0,0,0,0
./data/output_files/out/UN_101_em_10.lg, Incorrect,14,1,13,13,0,0.132385430188,12,132,9,13,0,0,0,0,10,9,0,9,9,1,0,0,0,0,0,0,0,0
./data/output_files/out/UN_101_em_11.lg, Incorrect,35,5,30,28,2,0.167217487312,24,552,19,29,1,0,0,0,20,16,0,16,16,4,0,0,0,0,0,0,0,0
./data/output_files/out/UN_101_em_12.lg, Incorrect,7,0,7,7,0,0.197202659437,5,20,3,7,0,5,0,0,3,3,0,3,3,0,0,0,0,1,1,0,0,0
./data/output_files/out/UN_101_em_13.lg, Incorrect,27,2,25,25,0,0.11883152934,20,380,15,25,0,18,0,0,16,16,0,16,14,2,0,0,0,1,0,0,0,0
./data/output_files/out/UN_101_em_14.lg, Incorrect,21,4,17,17,0,0.197113069488,14,182,10,17,0,0,0,0,11,10,0,10,7,4,0,0,0,0,0,0,0,0
./data/output_files/out/UN_101_em_15.lg, Incorrect,5,0,5,5,0,0.136082763488,6,30,3,5,0,6,0,0,4,4,0,4,4,0,0,0,0,1,1,0,0,0
./data/output_files/out/UN_101_em_16.lg, Incorrect,25,5,20,10,10,0.54839714401,8,56,3,14,5,3,2,1,4,6,0,3,2,2,0,0,0,0,0,0,0,0
./data/output_files/out/UN_101_em_17.lg, Incorrect,30,4,26,24,2,0.210072293806,17,272,9,25,1,0,0,0,10,8,0,8,7,3,0,0,0,0,0,0,0,0
./data/output_files/out/UN_101_em_18.lg, Incorrect,19,5,14,14,0,0.211497651752,14,182,12,14,0,9,0,0,13,13,0,13,8,5,0,0,0,1,0,0,0,0
./data/output_files/out/UN_101_em_19.lg, Incorrect,80,15,65,59,6,0.170789789839,50,2450,38,62,3,0,0,0,39,32,0,29,25,14,0,0,0,0,0,0,0,0
./data/output_files/out/UN_101_em_2.lg, Incorrect,9,2,7,7,0,0.231320858726,7,42,5,7,0,5,0,0,6,6,0,6,4,2,0,0,0,1,0,0,0,0
./data/output_files/out/UN_101_em_20.lg, Incorrect,16,4,12,12,0,0.4330407329,6,30,2,10,0,2,4,2,3,3,0,3,1,2,0,0,0,1,0,0,0,0
./data/output_files/out/UN_101_em_21.lg, Incorrect,5,1,4,4,0,0.215737865167,5,20,3,4,0,4,0,0,4,4,0,4,3,1,0,0,0,1,0,0,0,0
./data/output_files/out/UN_101_em_22.lg, Incorrect,26,5,21,19,2,0.219242134914,17,272,11,20,1,0,0,0,12,11,0,10,8,4,0,0,0,0,0,0,0,0
./data/output_files/out/UN_101_em_23.lg, Incorrect,15,1,14,14,0,0.125498473894,13,156,10,14,0,12,0,0,11,11,0,11,10,1,0,0,0,1,0,0,0,0
./data/output_files/out/UN_101_em_24.lg, Incorrect,37,6,31,29,2,0.16820831201,26,650,20,30,1,0,0,0,21,19,0,18,15,6,0,0,0,0,0,0,0,0
./data/output_files/out/UN_101_em_3.lg, Incorrect,7,1,6,6,0,0.249240852502,5,20,2,6,0,4,0,0,3,3,0,3,2,1,0,0,0,1,0,0,0,0
./data/output_files/out/UN_101_em_4.lg, Incorrect,34,3,31,31,0,0.107084278365,27,702,19,31,0,0,0,0,20,17,0,17,17,3,0,0,0,0,0,0,0,0
./data/output_files/out/UN_101_em_5.lg, Incorrect,24,6,18,16,2,0.330788654639,12,132,8,16,1,0,2,1,9,7,0,6,5,4,0,0,0,0,0,0,0,0
./data/output_files/out/UN_101_em_6.lg, Incorrect,45,14,31,25,6,0.273703425069,27,702,25,28,3,0,0,0,26,18,0,15,13,13,0,0,0,0,0,0,0,0
./data/output_files/out/UN_101_em_7.lg, Incorrect,31,4,27,17,10,0.353613763827,12,132,7,21,5,8,2,1,8,10,0,7,7,1,0,0,0,0,0,0,0,0
./data/output_files/out/UN_101_em_8.lg, Incorrect,15,0,15,15,0,0.136082763488,10,90,5,15,0,10,0,0,6,6,0,6,6,0,0,0,0,1,1,0,0,0
./data/output_files/out/UN_101_em_9.lg, Incorrect,28,4,24,22,2,0.271050760461,13,156,6,22,1,0,2,1,7,7,0,6,5,2,0,0,0,0,0,0,0,0
./data/output_files/out/UN_102_em_25.lg, Incorrect,24,4,20,14,6,0.31192784059,12,132,8,17,3,0,0,0,9,9,0,8,7,2,0,0,0,0,0,0,0,0
./data/output_files/out/UN_102_em_26.lg, Incorrect,55,11,44,42,2,0.246241465645,26,650,17,41,1,0,4,2,18,15,0,14,10,8,0,0,0,0,0,0,0,0
./data/output_files/out/UN_102_em_27.lg, Incorrect,12,4,8,8,0,0.259259259259,9,72,8,8,0,0,0,0,9,8,0,8,5,4,0,0,0,0,0,0,0,0
./data/output_files/out/UN_102_em_28.lg, Incorrect,23,6,17,13,4,0.522744802311,8,56,3,13,2,0,4,2,4,4,0,3,1,3,0,0,0,0,0,0,0,0
./data/output_files/out/UN_102_em_29.lg, Incorrect,16,4,12,6,6,0.707439742249,5,20,2,9,3,0,0,0,3,4,0,2,1,2,0,0,0,0,0,0,0,0
./data/output_files/out/UN_102_em_30.lg, Incorrect,5,1,4,4,0,0.215737865167,5,20,3,4,0,0,0,0,4,3,0,3,3,1,0,0,0,0,0,0,0,0
./data/output_files/out/UN_102_em_31.lg, Incorrect,24,6,18,12,6,0.548091181623,8,56,3,15,3,0,0,0,4,5,0,1,1,3,0,0,0,0,0,0,0,0
./data/output_files/out/UN_102_em_32.lg, Incorrect,10,2,8,8,0,0.209321491003,8,56,6,8,0,0,0,0,7,6,0,6,5,2,0,0,0,0,0,0,0,0
./data/output_files/out/UN_102_em_33.lg, Incorrect,8,0,8,8,0,0.12598815767,8,56,3,8,0,8,0,0,4,4,0,4,4,0,0,0,0,1,1,0,0,0
./data/output_files/out/UN_102_em_34.lg, Incorrect,33,1,32,32,0,0.0903133692253,25,600,18,32,0,24,0,0,19,19,0,19,18,1,0,0,0,1,0,0,0,0
./data/output_files/out/UN_102_em_35.lg, Incorrect,3,0,3,3,0,0.166666666667,4,12,2,3,0,4,0,0,3,3,0,3,3,0,0,0,0,1,1,0,0,0
./data/output_files/out/UN_102_em_36.lg, Incorrect,59,13,46,30,16,0.621092432319,13,156,4,35,8,0,6,3,5,8,0,1,0,5,0,0,0,0,0,0,0,0
./data/output_files/out/UN_102_em_37.lg, Incorrect,68,9,59,47,12,0.283124410078,24,552,15,50,6,0,6,3,16,17,0,13,13,3,0,0,0,0,0,0,0,0
./data/output_files/out/UN_102_em_38.lg, Incorrect,50,8,42,36,6,0.237809727515,24,552,15,39,3,0,0,0,16,16,0,13,11,5,0,0,0,0,0,0,0,0
./data/output_files/out/UN_102_em_39.lg, Incorrect,72,9,63,55,8,0.229382056083,29,812,18,57,4,0,4,2,19,14,0,12,11,8,0,0,0,0,0,0,0,0
./data/output_files/out/UN_102_em_40.lg, Incorrect,21,1,20,20,0,0.109995533895,17,272,12,20,0,0,0,0,13,12,0,12,12,1,0,0,0,0,0,0,0,0
./data/output_files/out/UN_102_em_41.lg, Incorrect,4,0,4,4,0,0.19245008973,4,12,2,4,0,4,0,0,3,3,0,3,3,0,0,0,0,1,1,0,0,0
./data/output_files/out/UN_102_em_42.lg, Incorrect,31,1,30,30,0,0.13030970383,17,272,9,30,0,0,0,0,10,9,0,9,9,1,0,0,0,0,0,0,0,0
./data/output_files/out/UN_102_em_43.lg, Incorrect,89,11,78,66,12,0.217317412871,36,1260,21,70,6,0,4,2,22,24,0,18,17,5,0,0,0,0,0,0,0,0
./data/output_files/out/UN_102_em_44.lg, Incorrect,40,8,32,30,2,0.195014135268,26,650,22,30,1,0,2,1,23,22,0,21,17,6,0,0,0,0,0,0,0,0
./data/output_files/out/UN_102_em_45.lg, Incorrect,98,18,80,68,12,0.248475778223,41,1640,28,71,6,0,6,3,29,25,0,20,15,14,0,0,0,0,0,0,0,0
./data/output_files/out/UN_102_em_46.lg, Incorrect,19,2,17,17,0,0.122549019608,17,272,13,17,0,0,0,0,14,12,0,12,12,2,0,0,0,0,0,0,0,0
./data/output_files/out/UN_102_em_47.lg, Incorrect,27,5,22,20,2,0.235517376109,16,240,10,21,1,0,0,0,11,10,0,8,7,4,0,0,0,0,0,0,0,0
./data/output_files/out/UN_102_em_48.lg, Incorrect,16,1,15,15,0,0.129003304465,13,156,9,15,0,12,0,0,10,10,0,10,9,1,0,0,0,1,0,0,0,0
./data/output_files/out/UN_102_em_49.lg, Incorrect,2,1,1,1,0,0.402368927062,2,2,1,1,0,1,0,0,2,2,0,2,1,1,0,0,0,1,0,0,0,0
./data/output_files/out/UN_103_em_50.lg, Incorrect,23,3,20,18,2,0.216870323341,14,182,9,19,1,0,0,0,10,10,0,9,8,2,0,0,0,0,0,0,0,0
./data/output_files/out/UN_103_em_51.lg, Incorrect,48,9,39,23,16,0.59833468334,11,110,3,30,8,0,2,1,4,5,0,1,1,3,0,0,0,0,0,0,0,0
./data/output_files/out/UN_103_em_52.lg, Incorrect,12,0,12,12,0,0.136082763488,9,72,5,12,0,9,0,0,6,6,0,6,6,0,0,0,0,1,1,0,0,0
./data/output_files/out/UN_103_em_53.lg, Incorrect,46,4,42,42,0,0.0818406087155,43,1806,42,42,0,0,0,0,43,42,0,42,39,4,0,0,0,0,0,0,0,0
./data/output_files/out/UN_103_em_54.lg, Incorrect,32,5,27,23,4,0.243482826161,17,272,10,25,2,0,0,0,11,12,0,9,8,3,0,0,0,0,0,0,0,0
./data/output_files/out/UN_103_em_55.lg, Incorrect,35,7,28,24,4,0.241348730741,20,380,16,26,2,0,0,0,17,15,0,12,12,5,0,0,0,0,0,0,0,0
./data/output_files/out/UN_103_em_56.lg, Incorrect,13,3,10,8,2,0.32885312129,8,56,5,9,1,0,0,0,6,5,0,4,4,2,0,0,0,0,0,0,0,0
./data/output_files/out/UN_103_em_57.lg, Incorrect,16,3,13,13,0,0.187940985743,12,132,9,13,0,0,0,0,10,9,0,9,7,3,0,0,0,0,0,0,0,0
./data/output_files/out/UN_103_em_58.lg, Incorrect,12,2,10,10,0,0.198300072824,9,72,6,10,0,0,0,0,7,6,0,6,5,2,0,0,0,0,0,0,0,0
./data/output_files/out/UN_103_em_59.lg, Incorrect,23,3,20,20,0,0.14921122017,17,272,13,20,0,0,0,0,14,12,0,12,11,3,0,0,0,0,0,0,0,0
./data/output_files/out/UN_103_em_60.lg, Incorrect,57,12,45,41,4,0.182676296546,38,1406,32,43,2,0,0,0,33,31,0,29,22,11,0,0,0,0,0,0,0,0
./data/output_files/out/UN_103_em_61.lg, Incorrect,46,9,37,33,4,0.185122268413,31,930,24,35,2,0,0,0,25,20,0,19,18,7,0,0,0,0,0,0,0,0
./data/output_files/out/UN_103_em_62.lg, Incorrect,22,6,16,8,8,0.490468173597,9,72,7,12,4,0,0,0,7,4,0,3,3,4,0,0,0,0,0,0,0,0
./data/output_files/out/UN_103_em_63.lg, Incorrect,96,21,75,65,10,0.244119436053,45,1980,33,67,5,0,6,3,34,32,0,27,20,14,0,0,0,0,0,0,0,0
./data/output_files/out/UN_103_em_64.lg, Incorrect,6,1,5,5,0,0.191638319044,6,30,4,5,0,5,0,0,5,5,0,5,4,1,0,0,0,1,0,0,0,0
./data/output_files/out/UN_103_em_65.lg, Incorrect,9,3,6,4,2,0.621785023883,4,12,2,5,1,0,0,0,3,2,0,1,1,2,0,0,0,0,0,0,0,0
./data/output_files/out/UN_103_em_66.lg, Incorrect,53,7,46,40,6,0.19525267909,28,756,17,43,3,0,0,0,18,18,0,15,14,4,0,0,0,0,0,0,0,0
./data/output_files/out/UN_103_em_67.lg, Incorrect,35,7,28,24,4,0.28462566412,17,272,11,25,2,0,2,1,12,11,0,9,8,4,0,0,0,0,0,0,0,0
./data/output_files/out/UN_103_em_68.lg, Incorrect,66,15,51,41,10,0.292943525598,29,812,23,45,5,0,2,1,23,19,0,15,13,10,0,0,0,0,0,0,0,0
./data/output_files/out/UN_103_em_69.lg, Incorrect,14,4,10,4,6,0.684943112897,5,20,2,7,3,0,0,0,3,3,0,1,1,2,0,0,0,0,0,0,0,0
./data/output_files/out/UN_103_em_70.lg, Incorrect,14,3,11,11,0,0.179558378198,12,132,11,11,0,0,0,0,12,11,0,11,9,3,0,0,0,0,0,0,0,0
./data/output_files/out/UN_103_em_72.lg, Incorrect,2,1,1,1,0,0.402368927062,2,2,1,1,0,1,0,0,2,2,0,2,1,1,0,0,0,1,0,0,0,0
./data/output_files/out/UN_103_em_73.lg, Incorrect,21,6,15,13,2,0.320063807404,12,132,11,14,1,0,0,0,11,9,0,8,6,5,0,0,0,0,0,0,0,0
./data/output_files/out/UN_103_em_74.lg, Incorrect,63,14,49,37,12,0.273810978946,30,870,19,42,6,0,2,1,20,19,0,12,11,9,0,0,0,0,0,0,0,0
./data/output_files/out/UN_104_em_75.lg, Incorrect,13,2,11,9,2,0.259918956291,9,72,8,10,1,0,0,0,8,8,0,7,7,1,0,0,0,0,0,0,0,0
./data/output_files/out/UN_104_em_76.lg, Incorrect,12,2,10,10,0,0.177777777778,10,90,6,10,0,0,0,0,7,6,0,6,5,2,0,0,0,0,0,0,0,0
./data/output_files/out/UN_104_em_77.lg, Incorrect,32,6,26,18,8,0.338730956308,14,182,9,22,4,0,0,0,10,11,0,8,7,3,0,0,0,0,0,0,0,0
./data/output_files/out/UN_104_em_78.lg, Incorrect,38,7,31,27,4,0.21359199594,23,506,17,28,2,0,2,1,18,15,0,14,12,6,0,0,0,0,0,0,0,0
./data/output_files/out/UN_104_em_79.lg, Incorrect,11,1,10,10,0,0.161263035787,9,72,6,10,0,0,0,0,7,6,0,6,6,1,0,0,0,0,0,0,0,0
./data/output_files/out/UN_104_em_80.lg, Incorrect,7,3,4,4,0,0.3490711985,5,20,4,4,0,0,0,0,5,3,0,3,2,3,0,0,0,0,0,0,0,0
./data/output_files/out/UN_104_em_81.lg, Incorrect,25,5,20,20,0,0.16832777048,19,342,16,20,0,0,0,0,17,13,0,13,12,5,0,0,0,0,0,0,0,0
./data/output_files/out/UN_104_em_82.lg, Incorrect,22,4,18,12,6,0.368470828416,10,90,6,15,3,0,0,0,7,5,0,5,5,2,0,0,0,0,0,0,0,0
./data/output_files/out/UN_104_em_83.lg, Incorrect,16,2,14,14,0,0.164112046769,12,132,8,14,0,10,0,0,9,9,0,9,7,2,0,0,0,1,0,0,0,0
./data/output_files/out/UN_104_em_84.lg, Incorrect,6,2,4,4,0,0.282404531833,5,20,4,4,0,0,0,0,5,4,0,4,3,2,0,0,0,0,0,0,0,0
./data/output_files/out/UN_104_em_85.lg, Incorrect,29,7,22,22,0,0.232054311793,17,272,13,21,0,0,2,1,14,13,0,13,8,6,0,0,0,0,0,0,0,0
./data/output_files/out/UN_104_em_86.lg, Incorrect,121,19,102,90,12,0.242347203773,45,1980,26,94,6,0,4,2,27,26,0,19,16,11,0,0,0,0,0,0,0,0
./data/output_files/out/UN_104_em_87.lg, Incorrect,7,3,4,4,0,0.3490711985,5,20,4,4,0,0,0,0,5,4,0,4,2,3,0,0,0,0,0,0,0,0
./data/output_files/out/UN_104_em_88.lg, Incorrect,8,2,6,2,4,0.594819016792,4,12,2,4,2,0,0,0,3,2,0,1,1,2,0,0,0,0,0,0,0,0
./data/output_files/out/UN_104_em_89.lg, Incorrect,24,7,17,13,4,0.499797565359,9,72,5,14,2,0,2,1,6,6,0,4,2,4,0,0,0,0,0,0,0,0
./data/output_files/out/UN_104_em_90.lg, Incorrect,35,11,24,22,2,0.264572107472,22,462,20,23,1,0,0,0,21,15,0,15,11,10,0,0,0,0,0,0,0,0
./data/output_files/out/UN_104_em_91.lg, Incorrect,12,4,8,8,0,0.259259259259,9,72,8,8,0,0,0,0,9,6,0,6,5,4,0,0,0,0,0,0,0,0
./data/output_files/out/UN_104_em_92.lg, Incorrect,53,13,40,36,4,0.423152063098,17,272,10,35,2,0,6,3,11,9,0,9,3,8,0,0,0,0,0,0,0,0
./data/output_files/out/UN_104_em_93.lg, Incorrect,11,1,10,8,2,0.407778182401,5,20,3,9,1,4,0,0,3,4,0,2,2,1,0,0,0,0,0,0,0,0
./data/output_files/out/UN_104_em_94.lg, Incorrect,51,11,40,32,8,0.30861176072,22,462,15,36,4,0,0,0,16,16,0,10,8,8,0,0,0,0,0,0,0,0
./data/output_files/out/UN_104_em_95.lg, Incorrect,13,3,10,10,0,0.211111111111,10,90,8,10,0,0,0,0,9,8,0,8,6,3,0,0,0,0,0,0,0,0
./data/output_files/out/UN_104_em_96.lg, Incorrect,14,4,10,6,4,0.651440125562,5,20,2,7,2,0,2,1,3,3,0,1,1,2,0,0,0,0,0,0,0,0
./data/output_files/out/UN_104_em_97.lg, Incorrect,23,6,17,17,0,0.200980392157,17,272,14,17,0,0,0,0,15,11,0,11,9,6,0,0,0,0,0,0,0,0
./data/output_files/out/UN_104_em_98.lg, Incorrect,16,5,11,9,2,0.301871064352,11,110,10,10,1,0,0,0,11,9,0,8,6,5,0,0,0,0,0,0,0,0
./data/output_files/out/UN_104_em_99.lg, Incorrect,38,8,30,24,6,0.206201220729,26,650,23,27,3,0,0,0,24,19,0,16,15,9,0,0,0,0,0,0,0,0
./data/output_files/out/UN_105_em_100.lg, Incorrect,9,4,5,5,0,0.35830498571,6,30,5,5,0,2,0,0,6,6,0,6,2,4,0,0,0,1,0,0,0,0
./data/output_files/out/UN_105_em_101.lg, Incorrect,4,2,2,2,0,0.414672311952,3,6,2,2,0,0,0,0,3,2,0,2,1,2,0,0,0,0,0,0,0,0
./data/output_files/out/UN_105_em_102.lg, Incorrect,16,4,12,10,2,0.383964095464,8,56,5,11,1,0,0,0,6,6,0,5,3,3,0,0,0,0,0,0,0,0
./data/output_files/out/UN_105_em_103.lg, Incorrect,56,13,43,23,20,0.426873869494,19,342,12,32,10,0,2,1,13,11,0,4,4,9,0,0,0,0,0,0,0,0
./data/output_files/out/UN_105_em_104.lg, Incorrect,48,10,38,28,10,0.34354850494,19,342,12,33,5,0,0,0,13,14,0,9,7,6,0,0,0,0,0,0,0,0
./data/output_files/out/UN_105_em_105.lg, Incorrect,21,3,18,12,6,0.374002822643,9,72,4,15,3,0,0,0,5,4,0,4,4,1,0,0,0,0,0,0,0,0
./data/output_files/out/UN_105_em_106.lg, Incorrect,43,8,35,25,10,0.362001817715,16,240,10,29,5,0,2,1,11,10,0,8,6,5,0,0,0,0,0,0,0,0
./data/output_files/out/UN_105_em_107.lg, Incorrect,11,3,8,6,2,0.424865556414,6,30,4,7,1,0,0,0,5,5,0,3,3,2,0,0,0,0,0,0,0,0
./data/output_files/out/UN_105_em_108.lg, Incorrect,4,2,2,2,0,0.414672311952,3,6,2,2,0,1,0,0,3,3,0,3,1,2,0,0,0,1,0,0,0,0
./data/output_files/out/UN_105_em_109.lg, Incorrect,34,3,31,31,0,0.111256767008,26,650,19,31,0,0,0,0,20,17,0,17,17,3,0,0,0,0,0,0,0,0
./data/output_files/out/UN_105_em_110.lg, Incorrect,11,3,8,8,0,0.25098815767,8,56,6,8,0,5,0,0,7,7,0,7,4,3,0,0,0,1,0,0,0,0
./data/output_files/out/UN_105_em_111.lg, Incorrect,11,2,9,9,0,0.21696395429,8,56,6,9,0,0,0,0,6,5,0,5,4,2,0,0,0,0,0,0,0,0
./data/output_files/out/UN_105_em_112.lg, Incorrect,16,4,12,8,4,0.55475685679,6,30,4,9,2,0,2,1,4,4,0,3,2,2,0,0,0,0,0,0,0,0
./data/output_files/out/UN_105_em_113.lg, Incorrect,9,2,7,7,0,0.231320858726,7,42,5,7,0,0,0,0,6,5,0,5,4,2,0,0,0,0,0,0,0,0
./data/output_files/out/UN_105_em_114.lg, Incorrect,49,6,43,39,4,0.169067923821,29,812,22,40,2,0,2,1,23,19,0,18,18,5,0,0,0,0,0,0,0,0
./data/output_files/out/UN_105_em_115.lg, Incorrect,45,11,34,30,4,0.210720266864,30,870,27,32,2,0,0,0,28,25,0,22,18,10,0,0,0,0,0,0,0,0
./data/output_files/out/UN_105_em_116.lg, Incorrect,23,9,14,12,2,0.341678574881,14,182,13,13,1,0,0,0,14,9,0,8,5,9,0,0,0,0,0,0,0,0
./data/output_files/out/UN_105_em_117.lg, Incorrect,11,4,7,7,0,0.463869326103,5,20,3,6,0,0,2,1,4,3,0,3,1,3,0,0,0,0,0,0,0,0
./data/output_files/out/UN_105_em_118.lg, Incorrect,30,6,24,20,4,0.217970060061,20,380,18,22,2,0,0,0,18,13,0,11,11,7,0,0,0,0,0,0,0,0
./data/output_files/out/UN_105_em_119.lg, Incorrect,10,2,8,6,2,0.369310000858,6,30,3,7,1,0,0,0,4,4,0,3,3,1,0,0,0,0,0,0,0,0
./data/output_files/out/UN_105_em_120.lg, Incorrect,8,2,6,4,2,0.53845169055,4,12,2,5,1,0,0,0,3,3,0,2,2,1,0,0,0,0,0,0,0,0
./data/output_files/out/UN_105_em_121.lg, Incorrect,4,0,4,4,0,0.19245008973,4,12,2,4,0,4,0,0,3,3,0,3,3,0,0,0,0,1,1,0,0,0
./data/output_files/out/UN_105_em_122.lg, Incorrect,2,0,2,2,0,0.19245008973,3,6,1,2,0,3,0,0,2,2,0,2,2,0,0,0,0,1,1,0,0,0
./data/output_files/out/UN_105_em_123.lg, Incorrect,7,2,5,5,0,0.247193874599,6,30,5,5,0,0,0,0,6,5,0,5,4,2,0,0,0,0,0,0,0,0
./data/output_files/out/UN_105_em_124.lg, Incorrect,19,5,14,14,0,0.211497651752,14,182,12,14,0,0,0,0,13,11,0,11,8,5,0,0,0,0,0,0,0,0
./data/output_files/out/UN_106_em_125.lg, Incorrect,5,1,4,4,0,0.275783423063,4,12,2,4,0,3,0,0,3,3,0,3,2,1,0,0,0,1,0,0,0,0
./data/output_files/out/UN_106_em_126.lg, Incorrect,41,7,34,20,14,0.434961221381,13,156,7,26,7,0,2,1,8,9,0,5,5,3,0,0,0,0,0,0,0,0
./data/output_files/out/UN_106_em_127.lg, Incorrect,57,11,46,40,6,0.251946663125,27,702,18,41,3,0,4,2,19,19,0,15,13,6,0,0,0,0,0,0,0,0
./data/output_files/out/UN_106_em_128.lg, Incorrect,8,2,6,6,0,0.260182309611,6,30,3,6,0,0,0,0,4,3,0,3,2,2,0,0,0,0,0,0,0,0
./data/output_files/out/UN_106_em_129.lg, Incorrect,17,4,13,11,2,0.280750720535,11,110,8,12,1,0,0,0,9,8,0,6,6,3,0,0,0,0,0,0,0,0
./data/output_files/out/UN_106_em_130.lg, Incorrect,24,6,18,18,0,0.203396351395,17,272,14,18,0,0,0,0,15,10,0,10,9,6,0,0,0,0,0,0,0,0
./data/output_files/out/UN_106_em_131.lg, Incorrect,14,4,10,6,4,0.651440125562,5,20,2,8,2,0,0,0,3,4,0,1,1,2,0,0,0,0,0,0,0,0
./data/output_files/out/UN_106_em_132.lg, Incorrect,67,17,50,42,8,0.237126140431,38,1406,32,45,4,0,2,1,32,25,0,22,17,15,0,0,0,0,0,0,0,0
./data/output_files/out/UN_106_em_133.lg, Incorrect,94,21,73,53,20,0.258838032598,44,1892,35,62,10,0,2,1,36,30,0,24,20,16,0,0,0,0,0,0,0,0
./data/output_files/out/UN_106_em_134.lg, Incorrect,22,5,17,11,6,0.677773193847,6,30,2,13,3,0,2,1,3,4,0,1,1,2,0,0,0,0,0,0,0,0
./data/output_files/out/UN_106_em_135.lg, Incorrect,42,4,38,36,2,0.118142754287,33,1056,26,37,1,0,0,0,27,25,0,24,23,4,0,0,0,0,0,0,0,0
./data/output_files/out/UN_106_em_136.lg, Incorrect,22,4,18,18,0,0.186478896184,15,210,9,18,0,11,0,0,10,10,0,10,6,4,0,0,0,1,0,0,0,0
./data/output_files/out/UN_106_em_137.lg, Incorrect,23,8,15,15,0,0.402749430155,10,90,7,13,0,0,4,2,8,5,0,5,2,6,0,0,0,0,0,0,0,0
./data/output_files/out/UN_106_em_138.lg, Incorrect,47,9,38,34,4,0.387799363855,15,210,8,32,2,6,8,4,9,8,0,7,4,5,0,0,0,0,0,0,0,0
./data/output_files/out/UN_106_em_139.lg, Incorrect,40,6,34,22,12,0.526594889608,10,90,3,27,6,0,2,1,4,6,0,2,2,2,0,0,0,0,0,0,0,0
./data/output_files/out/UN_106_em_140.lg, Incorrect,19,3,16,16,0,0.158675407912,15,210,12,16,0,0,0,0,13,10,0,10,10,3,0,0,0,0,0,0,0,0
./data/output_files/out/UN_106_em_141.lg, Incorrect,19,2,17,17,0,0.139284884103,15,210,11,17,0,0,0,0,12,11,0,11,10,2,0,0,0,0,0,0,0,0
./data/output_files/out/UN_106_em_142.lg, Incorrect,57,14,43,33,10,0.346929913741,23,506,14,38,5,0,0,0,15,17,0,9,6,9,0,0,0,0,0,0,0,0
./data/output_files/out/UN_106_em_143.lg, Incorrect,31,8,23,21,2,0.239522863723,20,380,17,22,1,0,0,0,18,15,0,14,11,7,0,0,0,0,0,0,0,0
./data/output_files/out/UN_106_em_144.lg, Incorrect,93,19,74,58,16,0.342049916953,31,930,18,66,8,0,0,0,19,22,0,10,7,12,0,0,0,0,0,0,0,0
./data/output_files/out/UN_106_em_145.lg, Incorrect,11,2,9,9,0,0.191925204272,9,72,7,9,0,0,0,0,8,7,0,7,6,2,0,0,0,0,0,0,0,0
./data/output_files/out/UN_106_em_146.lg, Incorrect,228,42,186,114,72,0.369636119298,58,3306,32,148,36,0,4,2,33,30,0,14,12,21,0,0,0,0,0,0,0,0
./data/output_files/out/UN_106_em_147.lg, Incorrect,123,23,100,76,24,0.207773904858,61,3660,47,87,12,0,2,1,48,48,0,37,31,17,0,0,0,0,0,0,0,0
./data/output_files/out/UN_106_em_148.lg, Incorrect,59,11,48,32,16,0.35235041343,21,420,13,40,8,0,0,0,14,19,0,10,9,5,0,0,0,0,0,0,0,0
./data/output_files/out/UN_106_em_149.lg, Incorrect,30,5,25,21,4,0.254782685686,16,240,11,23,2,0,0,0,12,13,0,10,9,3,0,0,0,0,0,0,0,0
./data/output_files/out/UN_107_em_150.lg, Incorrect,5,0,5,5,0,0.136082763488,6,30,3,5,0,6,0,0,4,4,0,4,4,0,0,0,0,1,1,0,0,0
./data/output_files/out/UN_107_em_151.lg, Incorrect,17,2,15,13,2,0.228644209083,11,110,7,14,1,9,0,0,8,9,0,7,7,1,0,0,0,0,0,0,0,0
./data/output_files/out/UN_107_em_152.lg, Incorrect,52,11,41,39,2,0.225723656615,28,756,20,38,1,0,4,2,21,16,0,15,13,8,0,0,0,0,0,0,0,0
./data/output_files/out/UN_107_em_153.lg, Incorrect,5,1,4,2,2,0.411866186551,4,12,2,3,1,3,0,0,3,2,0,1,1,2,0,0,0,0,0,0,0,0
./data/output_files/out/UN_107_em_154.lg, Incorrect,11,2,9,9,0,0.21696395429,8,56,6,9,0,6,0,0,7,7,0,7,5,2,0,0,0,1,0,0,0,0
./data/output_files/out/UN_107_em_155.lg, Incorrect,18,3,15,9,6,0.32214906007,10,90,8,12,3,7,0,0,9,7,0,6,6,3,0,0,0,0,0,0,0,0
./data/output_files/out/UN_107_em_156.lg, Incorrect,90,24,66,44,22,0.42576179623,29,812,16,55,11,0,0,0,17,15,0,5,3,14,0,0,0,0,0,0,0,0
./data/output_files/out/UN_107_em_157.lg, Incorrect,22,5,17,13,4,0.553033808163,7,42,5,14,2,0,2,1,5,3,0,2,2,3,0,0,0,0,0,0,0,0
./data/output_files/out/UN_107_em_158.lg, Incorrect,4,0,4,4,0,0.1490711985,5,20,4,4,0,5,0,0,5,5,0,5,5,0,0,0,0,1,1,0,0,0
./data/output_files/out/UN_107_em_159.lg, Incorrect,6,0,6,6,0,0.182574185835,5,20,2,6,0,5,0,0,3,3,0,3,3,0,0,0,0,1,1,0,0,0
./data/output_files/out/UN_107_em_160.lg, Incorrect,25,5,20,18,2,0.37349190643,10,90,5,18,1,0,2,1,6,6,0,5,3,3,0,0,0,0,0,0,0,0
./data/output_files/out/UN_107_em_161.lg, Incorrect,42,7,35,19,16,0.581748861939,10,90,3,26,8,0,2,1,4,7,0,2,2,2,0,0,0,0,0,0,0,0
./data/output_files/out/UN_107_em_162.lg, Incorrect,28,5,23,17,6,0.298067266964,14,182,9,20,3,0,0,0,10,11,0,8,7,3,0,0,0,0,0,0,0,0
./data/output_files/out/UN_107_em_163.lg, Incorrect,22,3,19,19,0,0.20979781844,12,132,6,19,0,0,0,0,7,6,0,6,4,3,0,0,0,0,0,0,0,0
./data/output_files/out/UN_107_em_164.lg, Incorrect,21,4,17,7,10,0.491183430795,8,56,5,11,5,4,2,1,6,4,0,3,3,3,0,0,0,0,0,0,0,0
./data/output_files/out/UN_107_em_165.lg, Incorrect,20,5,15,11,4,0.41589776018,9,72,5,13,2,0,0,0,6,4,0,3,3,3,0,0,0,0,0,0,0,0
./data/output_files/out/UN_107_em_166.lg, Incorrect,22,1,21,21,0,0.112227664842,17,272,10,21,0,0,0,0,11,10,0,10,10,1,0,0,0,0,0,0,0,0
./data/output_files/out/UN_107_em_167.lg, Incorrect,11,3,8,6,2,0.516227766017,5,20,2,7,1,0,0,0,3,3,0,2,1,2,0,0,0,0,0,0,0,0
./data/output_files/out/UN_107_em_168.lg, Incorrect,34,6,28,24,4,0.195005464854,23,506,19,26,2,0,0,0,20,17,0,15,15,5,0,0,0,0,0,0,0,0
./data/output_files/out/UN_107_em_169.lg, Incorrect,44,10,34,32,2,0.18671965991,31,930,28,33,1,0,0,0,29,20,0,20,20,9,0,0,0,0,0,0,0,0
./data/output_files/out/UN_107_em_170.lg, Incorrect,23,3,20,20,0,0.133240051182,19,342,16,20,0,16,0,0,17,17,0,17,14,3,0,0,0,1,0,0,0,0
./data/output_files/out/UN_107_em_171.lg, Incorrect,124,27,97,81,16,0.303743311392,45,1980,29,88,8,0,2,1,30,29,0,17,12,18,0,0,0,0,0,0,0,0
./data/output_files/out/UN_107_em_172.lg, Incorrect,7,1,6,6,0,0.249240852502,5,20,2,6,0,0,0,0,3,2,0,2,2,1,0,0,0,0,0,0,0,0
./data/output_files/out/UN_107_em_173.lg, Incorrect,34,2,32,32,0,0.144830648164,18,306,11,32,0,0,0,0,12,11,0,11,10,2,0,0,0,0,0,0,0,0
./data/output_files/out/UN_107_em_174.lg, Incorrect,18,5,13,13,0,0.22443017307,13,156,12,13,0,0,0,0,12,10,0,10,7,5,0,0,0,0,0,0,0,0
./data/output_files/out/UN_108_em_175.lg, Incorrect,15,3,12,12,0,0.22171612389,10,90,8,11,0,7,2,1,9,9,0,9,7,2,0,0,0,1,0,0,0,0
./data/output_files/out/UN_108_em_176.lg, Incorrect,28,2,26,26,0,0.120524727297,20,380,14,25,0,18,2,1,15,15,0,15,14,1,0,0,0,1,0,0,0,0
./data/output_files/out/UN_108_em_177.lg, Incorrect,15,1,14,14,0,0.125498473894,13,156,10,14,0,0,0,0,11,10,0,10,10,1,0,0,0,0,0,0,0,0
./data/output_files/out/UN_108_em_178.lg, Incorrect,16,2,14,14,0,0.151139499535,13,156,10,14,0,0,0,0,11,9,0,9,9,2,0,0,0,0,0,0,0,0
./data/output_files/out/UN_108_em_179.lg, Incorrect,117,25,92,64,28,0.40519117358,33,1056,18,75,14,0,6,3,19,15,0,9,4,15,0,0,0,0,0,0,0,0
./data/output_files/out/UN_108_em_180.lg, Incorrect,5,0,5,5,0,0.166666666667,5,20,3,5,0,5,0,0,4,4,0,4,4,0,0,0,0,1,1,0,0,0
./data/output_files/out/UN_108_em_181.lg, Incorrect,15,3,12,10,2,0.342297428797,8,56,5,11,1,0,0,0,6,5,0,4,4,2,0,0,0,0,0,0,0,0
./data/output_files/out/UN_108_em_182.lg, Incorrect,23,4,19,7,12,0.408205554469,10,90,8,13,6,6,0,0,9,6,0,5,5,4,0,0,0,0,0,0,0,0
./data/output_files/out/UN_108_em_183.lg, Incorrect,49,8,41,35,6,0.270971904135,21,420,15,38,3,0,0,0,16,17,0,12,11,5,0,0,0,0,0,0,0,0
./data/output_files/out/UN_108_em_184.lg, Incorrect,111,20,91,65,26,0.252175122042,46,2070,26,74,13,0,8,4,27,30,0,20,18,9,0,0,0,0,0,0,0,0
./data/output_files/out/UN_108_em_185.lg, Incorrect,44,9,35,23,12,0.446054149339,14,182,8,28,6,0,2,1,9,10,0,7,4,5,0,0,0,0,0,0,0,0
./data/output_files/out/UN_108_em_186.lg, Incorrect,30,4,26,24,2,0.210072293806,17,272,11,25,1,0,0,0,12,11,0,9,9,3,0,0,0,0,0,0,0,0
./data/output_files/out/UN_108_em_187.lg, Incorrect,14,3,11,11,0,0.272734210071,8,56,5,10,0,0,2,1,6,5,0,5,4,2,0,0,0,0,0,0,0,0
./data/output_files/out/UN_108_em_188.lg, Incorrect,8,3,5,5,0,0.302749430155,6,30,5,5,0,0,0,0,6,5,0,5,3,3,0,0,0,0,0,0,0,0
./data/output_files/out/UN_108_em_189.lg, Incorrect,41,8,33,17,16,0.504940659526,12,132,6,25,8,0,0,0,7,7,0,3,3,4,0,0,0,0,0,0,0,0
./data/output_files/out/UN_108_em_190.lg, Incorrect,72,12,60,44,16,0.422242694611,19,342,8,49,8,0,6,3,9,8,0,6,4,5,0,0,0,0,0,0,0,0
./data/output_files/out/UN_108_em_191.lg, Incorrect,13,0,13,13,0,0.141639430933,9,72,4,13,0,9,0,0,5,5,0,5,5,0,0,0,0,1,1,0,0,0
./data/output_files/out/UN_108_em_192.lg, Incorrect,20,5,15,15,0,0.214742494341,14,182,11,15,0,0,0,0,12,11,0,11,7,5,0,0,0,0,0,0,0,0
./data/output_files/out/UN_108_em_193.lg, Incorrect,14,3,11,7,4,0.490226147497,6,30,3,8,2,3,2,1,4,5,0,3,3,1,0,0,0,0,0,0,0,0
./data/output_files/out/UN_108_em_194.lg, Incorrect,77,14,63,57,6,0.173752028796,47,2162,32,60,3,0,0,0,33,30,0,27,21,12,0,0,0,0,0,0,0,0
./data/output_files/out/UN_108_em_195.lg, Incorrect,24,4,20,16,4,0.36074101049,10,90,5,18,2,0,0,0,6,6,0,4,4,2,0,0,0,0,0,0,0,0
./data/output_files/out/UN_108_em_196.lg, Incorrect,79,15,64,50,14,0.213364965898,42,1722,34,55,7,0,4,2,35,31,0,28,23,12,0,0,0,0,0,0,0,0
./data/output_files/out/UN_108_em_197.lg, Incorrect,35,11,24,24,0,0.242640384306,22,462,18,24,0,0,0,0,19,16,0,16,8,11,0,0,0,0,0,0,0,0
./data/output_files/out/UN_108_em_198.lg, Incorrect,59,9,50,42,8,0.265450161933,24,552,14,44,4,0,4,2,15,14,0,11,10,5,0,0,0,0,0,0,0,0
./data/output_files/out/UN_108_em_199.lg, Incorrect,10,2,8,6,2,0.44956109935,5,20,2,7,1,0,0,0,3,3,0,2,2,1,0,0,0,0,0,0,0,0
./data/output_files/out/UN_109_em_200.lg, Incorrect,43,6,37,19,18,0.429410779596,13,156,5,27,9,0,2,1,6,8,0,5,4,2,0,0,0,0,0,0,0,0
./data/output_files/out/UN_109_em_201.lg, Incorrect,42,10,32,18,14,0.550456256963,12,132,7,25,7,0,0,0,8,7,0,3,2,6,0,0,0,0,0,0,0,0
./data/output_files/out/UN_109_em_202.lg, Incorrect,14,4,10,10,0,0.307525709121,8,56,6,9,0,0,2,1,7,5,0,5,4,3,0,0,0,0,0,0,0,0
./data/output_files/out/UN_109_em_203.lg, Incorrect,44,13,31,31,0,0.239461895213,26,650,22,30,0,0,2,1,23,21,0,21,11,12,0,0,0,0,0,0,0,0
./data/output_files/out/UN_109_em_204.lg, Incorrect,18,5,13,13,0,0.266107093341,11,110,9,12,0,0,2,1,10,7,0,7,6,4,0,0,0,0,0,0,0,0
./data/output_files/out/UN_109_em_205.lg, Incorrect,17,2,15,13,2,0.281774784492,9,72,5,14,1,7,0,0,6,7,0,5,5,1,0,0,0,0,0,0,0,0
./data/output_files/out/UN_109_em_206.lg, Incorrect,69,13,56,38,18,0.319976604383,26,650,16,47,9,0,0,0,17,22,0,13,10,7,0,0,0,0,0,0,0,0
./data/output_files/out/UN_109_em_207.lg, Incorrect,29,3,26,24,2,0.190464450669,17,272,11,25,1,0,0,0,12,12,0,11,10,2,0,0,0,0,0,0,0,0
./data/output_files/out/UN_109_em_208.lg, Incorrect,50,8,42,28,14,0.41291527286,15,210,7,34,7,0,2,1,8,8,0,6,5,3,0,0,0,0,0,0,0,0
./data/output_files/out/UN_109_em_209.lg, Incorrect,9,3,6,4,2,0.401804161749,6,30,5,5,1,3,0,0,6,5,0,4,3,3,0,0,0,0,0,0,0,0
./data/output_files/out/UN_109_em_210.lg, Incorrect,68,13,55,37,18,0.395980239693,21,420,12,44,9,0,4,2,12,15,0,7,6,6,0,0,0,0,0,0,0,0
./data/output_files/out/UN_109_em_211.lg, Incorrect,2,1,1,1,0,0.402368927062,2,2,1,1,0,1,0,0,2,2,0,2,1,1,0,0,0,1,0,0,0,0
./data/output_files/out/UN_109_em_212.lg, Incorrect,42,10,32,26,6,0.512966671202,12,132,6,26,3,0,6,3,7,6,0,6,2,5,0,0,0,0,0,0,0,0
./data/output_files/out/UN_109_em_213.lg, Incorrect,28,4,24,20,4,0.311270807333,12,132,7,22,2,0,0,0,7,6,0,5,5,2,0,0,0,0,0,0,0,0
./data/output_files/out/UN_109_em_214.lg, Incorrect,26,5,21,17,4,0.281691943573,14,182,11,18,2,0,2,1,11,9,0,8,8,3,0,0,0,0,0,0,0,0
./data/output_files/out/UN_109_em_215.lg, Incorrect,40,9,31,25,6,0.444733913856,13,156,8,25,3,0,6,3,9,8,0,7,3,6,0,0,0,0,0,0,0,0
./data/output_files/out/UN_109_em_216.lg, Incorrect,11,1,10,10,0,0.144444444444,10,90,6,10,0,9,0,0,7,7,0,7,6,1,0,0,0,1,0,0,0,0
./data/output_files/out/UN_109_em_217.lg, Incorrect,18,2,16,14,2,0.232681063336,11,110,9,15,1,0,0,0,9,9,0,8,8,1,0,0,0,0,0,0,0,0
./data/output_files/out/UN_109_em_218.lg, Incorrect,24,3,21,21,0,0.151443351116,17,272,12,21,0,0,0,0,13,11,0,11,10,3,0,0,0,0,0,0,0,0
./data/output_files/out/UN_109_em_219.lg, Incorrect,6,0,6,6,0,0.182574185835,5,20,2,6,0,5,0,0,3,3,0,3,3,0,0,0,0,1,1,0,0,0
./data/output_files/out/UN_109_em_220.lg, Incorrect,29,6,23,19,4,0.289652309378,15,210,11,21,2,9,0,0,12,14,0,10,8,4,0,0,0,0,0,0,0,0
./data/output_files/out/UN_109_em_221.lg, Incorrect,5,0,5,5,0,0.166666666667,5,20,3,5,0,5,0,0,4,4,0,4,4,0,0,0,0,1,1,0,0,0
./data/output_files/out/UN_109_em_222.lg, Incorrect,4,1,3,1,2,0.539263461237,3,6,2,2,1,2,0,0,3,2,0,1,1,2,0,0,0,0,0,0,0,0
./data/output_files/out/UN_109_em_223.lg, Incorrect,24,7,17,13,4,0.317958262028,14,182,11,15,2,0,0,0,12,11,0,8,6,6,0,0,0,0,0,0,0,0
./data/output_files/out/UN_109_em_224.lg, Incorrect,3,0,3,3,0,0.166666666667,4,12,3,3,0,4,0,0,4,4,0,4,4,0,0,0,0,1,1,0,0,0
./data/output_files/out/UN_110_em_225.lg, Incorrect,43,5,38,34,4,0.170847452098,26,650,15,35,2,0,2,1,16,15,0,14,13,3,0,0,0,0,0,0,0,0
./data/output_files/out/UN_110_em_226.lg, Incorrect,12,0,12,12,0,0.178174161275,7,42,2,12,0,7,0,0,3,3,0,3,3,0,0,0,0,1,1,0,0,0
./data/output_files/out/UN_110_em_227.lg, Incorrect,40,7,33,27,6,0.302867370113,17,272,9,30,3,0,0,0,10,12,0,7,6,4,0,0,0,0,0,0,0,0
./data/output_files/out/UN_110_em_228.lg, Incorrect,60,5,55,45,10,0.264221458752,20,380,8,50,5,0,0,0,9,12,0,6,6,3,0,0,0,0,0,0,0,0
./data/output_files/out/UN_110_em_229.lg, Incorrect,58,8,50,40,10,0.256297813854,24,552,12,45,5,0,0,0,13,16,0,8,6,7,0,0,0,0,0,0,0,0
./data/output_files/out/UN_110_em_230.lg, Incorrect,28,6,22,8,14,0.625594390176,8,56,3,15,7,0,0,0,4,7,0,2,2,2,0,0,0,0,0,0,0,0
./data/output_files/out/UN_110_em_231.lg, Incorrect,41,5,36,32,4,0.245035779386,18,306,9,34,2,0,0,0,10,10,0,8,7,3,0,0,0,0,0,0,0,0
./data/output_files/out/UN_110_em_232.lg, Incorrect,11,2,9,7,2,0.379751593529,6,30,3,8,1,0,0,0,4,4,0,3,3,1,0,0,0,0,0,0,0,0
./data/output_files/out/UN_110_em_233.lg, Incorrect,30,5,25,25,0,0.187869584338,18,306,12,25,0,0,0,0,13,9,0,9,8,5,0,0,0,0,0,0,0,0
./data/output_files/out/UN_110_em_234.lg, Incorrect,25,7,18,12,6,0.589757848289,8,56,4,15,3,0,0,0,5,6,0,2,1,4,0,0,0,0,0,0,0,0
./data/output_files/out/UN_110_em_235.lg, Incorrect,26,5,21,21,0,0.190659037391,17,272,16,21,0,0,0,0,15,13,0,13,10,5,0,0,0,0,0,0,0,0
./data/output_files/out/UN_110_em_237.lg, Incorrect,53,9,44,34,10,0.317499981607,20,380,11,38,5,0,2,1,12,13,0,8,6,6,0,0,0,0,0,0,0,0
./data/output_files/out/UN_110_em_238.lg, Incorrect,78,14,64,50,14,0.320559606193,27,702,15,57,7,0,0,0,16,18,0,9,8,8,0,0,0,0,0,0,0,0
./data/output_files/out/UN_110_em_239.lg, Incorrect,30,5,25,21,4,0.239518330291,17,272,11,23,2,0,0,0,12,13,0,10,8,4,0,0,0,0,0,0,0,0
./data/output_files/out/UN_110_em_240.lg, Incorrect,27,3,24,18,6,0.207345660858,17,272,12,21,3,0,0,0,13,12,0,9,9,4,0,0,0,0,0,0,0,0
./data/output_files/out/UN_110_em_241.lg, Incorrect,39,8,31,27,4,0.262739373499,20,380,14,28,2,0,2,1,15,12,0,11,9,6,0,0,0,0,0,0,0,0
./data/output_files/out/UN_110_em_242.lg, Incorrect,62,14,48,34,14,0.415784100214,20,380,10,38,7,0,6,3,11,13,0,8,4,7,0,0,0,0,0,0,0,0
./data/output_files/out/UN_110_em_243.lg, Incorrect,32,4,28,24,4,0.201601873879,19,342,13,26,2,0,0,0,14,14,0,11,10,4,0,0,0,0,0,0,0,0
./data/output_files/out/UN_110_em_244.lg, Incorrect,34,7,27,17,10,0.436947097161,12,132,7,21,5,0,2,1,7,7,0,3,3,4,0,0,0,0,0,0,0,0
./data/output_files/out/UN_110_em_245.lg, Incorrect,22,2,20,18,2,0.168320742504,16,240,12,19,1,0,0,0,13,13,0,12,12,1,0,0,0,0,0,0,0,0
./data/output_files/out/UN_110_em_246.lg, Incorrect,29,7,22,16,6,0.319788985032,15,210,10,18,3,0,2,1,11,12,0,8,6,5,0,0,0,0,0,0,0,0
./data/output_files/out/UN_110_em_247.lg, Incorrect,69,19,50,40,10,0.232995163113,42,1722,37,45,5,0,0,0,38,29,0,22,18,20,0,0,0,0,0,0,0,0
./data/output_files/out/UN_110_em_248.lg, Incorrect,6,2,4,4,0,0.282404531833,5,20,3,4,0,0,0,0,4,2,0,2,2,2,0,0,0,0,0,0,0,0
./data/output_files/out/UN_110_em_249.lg, Incorrect,36,6,30,28,2,0.217841122829,20,380,11,29,1,0,0,0,12,12,0,10,7,5,0,0,0,0,0,0,0,0
./data/output_files/out/UN_111_em_250.lg, Incorrect,8,2,6,6,0,0.402368927062,4,12,2,5,0,2,2,1,3,3,0,3,2,1,0,0,0,1,0,0,0,0
./data/output_files/out/UN_111_em_251.lg, Incorrect,11,4,7,5,2,0.469303815984,6,30,3,6,1,2,0,0,4,5,0,3,1,3,0,0,0,0,0,0,0,0
./data/output_files/out/UN_111_em_252.lg, Incorrect,28,5,23,23,0,0.157369284923,21,420,16,23,0,0,0,0,17,16,0,16,12,5,0,0,0,0,0,0,0,0
./data/output_files/out/UN_111_em_253.lg, Incorrect,3,1,2,2,0,0.303561200841,3,6,2,2,0,2,0,0,3,3,0,3,2,1,0,0,0,1,0,0,0,0
./data/output_files/out/UN_111_em_254.lg, Incorrect,53,9,44,44,0,0.14562354562,36,1260,26,44,0,0,0,0,27,23,0,23,18,9,0,0,0,0,0,0,0,0
./data/output_files/out/UN_111_em_255.lg, Incorrect,18,4,14,14,0,0.333333333333,8,56,4,12,0,4,4,2,5,5,0,5,3,2,0,0,0,1,0,0,0,0
./data/output_files/out/UN_111_em_256.lg, Incorrect,34,6,28,26,2,0.214665327342,20,380,14,26,1,14,2,1,15,16,0,14,11,4,0,0,0,0,0,0,0,0
./data/output_files/out/UN_111_em_257.lg, Incorrect,46,7,39,33,6,0.230288317195,23,506,15,36,3,0,0,0,16,13,0,13,11,5,0,0,0,0,0,0,0,0
./data/output_files/out/UN_111_em_258.lg, Incorrect,10,4,6,6,0,0.569035593729,4,12,2,5,0,0,2,1,3,2,0,2,0,3,0,0,0,0,0,0,0,0
./data/output_files/out/UN_111_em_259.lg, Incorrect,35,2,33,31,2,0.155745823629,20,380,11,32,1,0,0,0,12,12,0,11,11,1,0,0,0,0,0,0,0,0
./data/output_files/out/UN_111_em_260.lg, Incorrect,13,2,11,11,0,0.166015315945,11,110,8,11,0,0,0,0,9,8,0,8,7,2,0,0,0,0,0,0,0,0
./data/output_files/out/UN_111_em_261.lg, Incorrect,25,5,20,10,10,0.742393394484,6,30,2,14,5,1,2,1,3,5,0,2,1,2,0,0,0,0,0,0,0,0
./data/output_files/out/UN_111_em_262.lg, Incorrect,68,10,58,54,4,0.193729208942,34,1122,21,56,2,0,0,0,22,23,0,20,14,8,0,0,0,0,0,0,0,0
./data/output_files/out/UN_111_em_263.lg, Incorrect,23,5,18,14,4,0.320006265187,12,132,8,16,2,0,0,0,9,9,0,7,6,3,0,0,0,0,0,0,0,0
./data/output_files/out/UN_111_em_264.lg, Incorrect,28,6,22,18,4,0.332400141148,13,156,8,19,2,0,2,1,9,8,0,7,5,4,0,0,0,0,0,0,0,0
./data/output_files/out/UN_112_em_265.lg, Incorrect,37,7,30,22,8,0.435415869972,12,132,5,25,4,0,2,1,6,7,0,4,3,3,0,0,0,0,0,0,0,0
./data/output_files/out/UN_112_em_266.lg, Incorrect,19,3,16,16,0,0.148566296582,16,240,13,16,0,0,0,0,14,13,0,13,11,3,0,0,0,0,0,0,0,0
./data/output_files/out/UN_112_em_267.lg, Incorrect,21,4,17,17,0,0.212601651193,13,156,7,17,0,0,0,0,8,7,0,7,4,4,0,0,0,0,0,0,0,0
./data/output_files/out/UN_112_em_268.lg, Incorrect,61,14,47,43,4,0.196336920553,39,1482,32,45,2,0,0,0,33,28,0,25,20,13,0,0,0,0,0,0,0,0
./data/output_files/out/UN_112_em_269.lg, Incorrect,18,5,13,9,4,0.618920764536,6,30,3,10,2,0,2,1,4,3,0,2,1,3,0,0,0,0,0,0,0,0
./data/output_files/out/UN_112_em_270.lg, Incorrect,30,6,24,22,2,0.231411519495,18,306,14,23,1,0,0,0,15,13,0,12,10,5,0,0,0,0,0,0,0,0
./data/output_files/out/UN_112_em_271.lg, Incorrect,57,13,44,38,6,0.391782939974,19,342,12,36,3,0,10,5,13,12,0,10,6,7,0,0,0,0,0,0,0,0
./data/output_files/out/UN_112_em_272.lg, Incorrect,21,3,18,18,0,0.176257055101,14,182,9,18,0,0,0,0,10,8,0,8,7,3,0,0,0,0,0,0,0,0
./data/output_files/out/UN_112_em_273.lg, Incorrect,18,3,15,15,0,0.155753747304,15,210,13,15,0,0,0,0,14,12,0,12,11,3,0,0,0,0,0,0,0,0
./data/output_files/out/UN_112_em_274.lg, Incorrect,23,6,17,11,6,0.623772113477,7,42,3,13,3,0,2,1,4,5,0,1,1,3,0,0,0,0,0,0,0,0
./data/output_files/out/UN_112_em_275.lg, Incorrect,9,2,7,7,0,0.201184463531,8,56,7,7,0,0,0,0,8,6,0,6,6,2,0,0,0,0,0,0,0,0
./data/output_files/out/UN_112_em_276.lg, Incorrect,5,1,4,4,0,0.215737865167,5,20,2,4,0,4,0,0,3,3,0,3,2,1,0,0,0,1,0,0,0,0
./data/output_files/out/UN_112_em_277.lg, Incorrect,18,0,18,18,0,0.104828483672,14,182,10,18,0,14,0,0,11,11,0,11,11,0,0,0,0,1,1,0,0,0
./data/output_files/out/UN_112_em_278.lg, Incorrect,33,3,30,30,0,0.10594522292,27,702,21,30,0,24,0,0,22,22,0,22,19,3,0,0,0,1,0,0,0,0
./data/output_files/out/UN_112_em_279.lg, Incorrect,28,4,24,24,0,0.167426079676,18,306,10,24,0,14,0,0,11,11,0,11,7,4,0,0,0,1,0,0,0,0
./data/output_files/out/UN_112_em_280.lg, Incorrect,14,3,11,11,0,0.241400437773,9,72,5,11,0,0,0,0,6,3,0,3,3,3,0,0,0,0,0,0,0,0
./data/output_files/out/UN_112_em_281.lg, Incorrect,38,2,36,36,0,0.104087479696,26,650,20,36,0,0,0,0,20,19,0,19,18,2,0,0,0,0,0,0,0,0
./data/output_files/out/UN_112_em_282.lg, Incorrect,8,2,6,6,0,0.402368927062,4,12,2,5,0,2,2,1,3,3,0,3,2,1,0,0,0,1,0,0,0,0
./data/output_files/out/UN_112_em_283.lg, Incorrect,25,3,22,22,0,0.130204417198,20,380,16,22,0,0,0,0,17,16,0,16,14,3,0,0,0,0,0,0,0,0
./data/output_files/out/UN_113_em_284.lg, Incorrect,9,0,9,9,0,0.117851130198,9,72,5,9,0,9,0,0,6,6,0,6,6,0,0,0,0,1,1,0,0,0
./data/output_files/out/UN_113_em_285.lg, Incorrect,13,3,10,8,2,0.290892665417,9,72,9,9,1,0,0,0,9,7,0,6,6,3,0,0,0,0,0,0,0,0
./data/output_files/out/UN_113_em_286.lg, Incorrect,20,4,16,14,2,0.247058772906,13,156,9,15,1,0,0,0,10,9,0,8,7,3,0,0,0,0,0,0,0,0
./data/output_files/out/UN_113_em_287.lg, Incorrect,7,1,6,6,0,0.204626754056,6,30,6,6,0,0,0,0,6,5,0,5,5,1,0,0,0,0,0,0,0,0
./data/output_files/out/UN_113_em_288.lg, Incorrect,60,6,54,52,2,0.177660468729,28,756,17,53,1,0,0,0,18,16,0,15,13,5,0,0,0,0,0,0,0,0
./data/output_files/out/UN_113_em_289.lg, Incorrect,18,3,15,11,4,0.524085050952,6,30,2,12,2,0,2,1,3,3,0,2,2,1,0,0,0,0,0,0,0,0
./data/output_files/out/UN_113_em_290.lg, Incorrect,38,11,27,21,6,0.298959553721,21,420,16,24,3,0,0,0,17,18,0,13,9,8,0,0,0,0,0,0,0,0
./data/output_files/out/UN_113_em_291.lg, Incorrect,24,4,20,10,10,0.506730477344,8,56,3,14,5,0,2,1,4,5,0,3,3,1,0,0,0,0,0,0,0,0
./data/output_files/out/UN_113_em_292.lg, Incorrect,28,9,19,17,2,0.384842205316,13,156,9,16,1,0,4,2,10,9,0,7,4,6,0,0,0,0,0,0,0,0
./data/output_files/out/UN_113_em_293.lg, Incorrect,28,5,23,19,4,0.235391819532,17,272,13,21,2,0,0,0,14,15,0,12,11,3,0,0,0,0,0,0,0,0
./data/output_files/out/UN_113_em_294.lg, Incorrect,7,0,7,7,0,0.136082763488,7,42,5,7,0,7,0,0,6,6,0,6,6,0,0,0,0,1,1,0,0,0
./data/output_files/out/UN_113_em_295.lg, Incorrect,49,13,36,30,6,0.257196895053,28,756,23,33,3,0,0,0,24,15,0,13,12,12,0,0,0,0,0,0,0,0
./data/output_files/out/UN_114_em_296.lg, Incorrect,20,2,18,16,2,0.187390359182,14,182,10,17,1,0,0,0,11,10,0,10,10,1,0,0,0,0,0,0,0,0
./data/output_files/out/UN_114_em_297.lg, Incorrect,58,14,44,34,10,0.319966908343,25,600,17,38,5,0,2,1,18,16,0,10,8,10,0,0,0,0,0,0,0,0
./data/output_files/out/UN_114_em_298.lg, Incorrect,10,2,8,6,2,0.44956109935,5,20,3,7,1,3,0,0,4,5,0,3,2,2,0,0,0,0,0,0,0,0
./data/output_files/out/UN_114_em_299.lg, Incorrect,18,5,13,9,4,0.363625661904,10,90,9,11,2,0,0,0,9,8,0,6,4,5,0,0,0,0,0,0,0,0
./data/output_files/out/UN_114_em_300.lg, Incorrect,24,6,18,16,2,0.24671612389,16,240,14,17,1,0,0,0,15,12,0,11,10,5,0,0,0,0,0,0,0,0
./data/output_files/out/UN_114_em_301.lg, Incorrect,37,8,29,23,6,0.297440611525,18,306,11,26,3,0,0,0,12,9,0,6,6,6,0,0,0,0,0,0,0,0
./data/output_files/out/UN_114_em_302.lg, Incorrect,18,2,16,16,0,0.127732963249,16,240,14,16,0,0,0,0,15,13,0,13,13,2,0,0,0,0,0,0,0,0
./data/output_files/out/UN_114_em_303.lg, Incorrect,5,3,2,2,0,0.525783423063,3,6,2,2,0,0,0,0,3,3,0,3,0,3,0,0,0,1,0,0,0,0
./data/output_files/out/UN_114_em_304.lg, Incorrect,26,4,22,22,0,0.163451814801,18,306,12,22,0,0,0,0,13,9,0,9,9,4,0,0,0,0,0,0,0,0
./data/output_files/out/UN_114_em_305.lg, Incorrect,31,9,22,18,4,0.31169260224,17,272,12,20,2,0,0,0,13,12,0,10,6,7,0,0,0,0,0,0,0,0
./data/output_files/out/UN_114_em_306.lg, Incorrect,52,9,43,33,10,0.224977077113,28,756,19,38,5,0,0,0,20,19,0,14,12,8,0,0,0,0,0,0,0,0
./data/output_files/out/UN_114_em_307.lg, Incorrect,2,0,2,2,0,0.19245008973,3,6,2,2,0,3,0,0,3,3,0,3,3,0,0,0,0,1,1,0,0,0
./data/output_files/out/UN_114_em_308.lg, Incorrect,36,5,31,21,10,0.27448473224,17,272,11,25,5,0,2,1,12,13,0,11,10,2,0,0,0,0,0,0,0,0
./data/output_files/out/UN_114_em_309.lg, Incorrect,17,5,12,10,2,0.489008696116,7,42,3,10,1,0,2,1,4,3,0,2,1,3,0,0,0,0,0,0,0,0
./data/output_files/out/UN_114_em_310.lg, Incorrect,3,1,2,2,0,0.303561200841,3,6,2,2,0,0,0,0,3,2,0,2,2,1,0,0,0,0,0,0,0,0
./data/output_files/out/UN_115_em_311.lg, Incorrect,12,3,9,7,2,0.321624699791,8,56,5,8,1,0,0,0,6,6,0,4,4,2,0,0,0,0,0,0,0,0
./data/output_files/out/UN_115_em_312.lg, Incorrect,41,7,34,26,8,0.26473892361,20,380,15,30,4,0,0,0,15,16,0,13,11,4,0,0,0,0,0,0,0,0
./data/output_files/out/UN_115_em_313.lg, Incorrect,19,4,15,13,2,0.289250269689,11,110,7,14,1,0,0,0,8,8,0,7,4,4,0,0,0,0,0,0,0,0
./data/output_files/out/UN_115_em_314.lg, Incorrect,8,0,8,8,0,0.145478593491,7,42,4,8,0,7,0,0,5,5,0,5,5,0,0,0,0,1,1,0,0,0
./data/output_files/out/UN_115_em_315.lg, Incorrect,38,8,30,24,6,0.268877305321,20,380,13,27,3,12,0,0,14,17,0,11,9,5,0,0,0,0,0,0,0,0
./data/output_files/out/UN_115_em_316.lg, Incorrect,25,5,20,20,0,0.247557607212,13,156,8,18,0,8,4,2,9,9,0,9,6,3,0,0,0,1,0,0,0,0
./data/output_files/out/UN_115_em_317.lg, Incorrect,42,11,31,23,8,0.363696477115,18,306,11,26,4,0,2,1,12,11,0,6,5,7,0,0,0,0,0,0,0,0
./data/output_files/out/UN_116_em_318.lg, Incorrect,6,2,4,4,0,0.282404531833,5,20,4,4,0,0,0,0,5,4,0,4,3,2,0,0,0,0,0,0,0,0
./data/output_files/out/UN_116_em_319.lg, Incorrect,43,6,37,33,4,0.189992466174,25,600,18,35,2,0,0,0,19,19,0,17,15,4,0,0,0,0,0,0,0,0
./data/output_files/out/UN_116_em_320.lg, Incorrect,22,4,18,12,6,0.41103985968,9,72,4,15,3,0,0,0,5,6,0,4,3,2,0,0,0,0,0,0,0,0
./data/output_files/out/UN_116_em_321.lg, Incorrect,32,10,22,20,2,0.339684042776,16,240,12,20,1,0,2,1,13,12,0,11,5,8,0,0,0,0,0,0,0,0
./data/output_files/out/UN_116_em_322.lg, Incorrect,26,5,21,19,2,0.219242134914,17,272,13,20,1,0,0,0,14,13,0,11,10,4,0,0,0,0,0,0,0,0
./data/output_files/out/UN_116_em_323.lg, Incorrect,38,12,26,16,10,0.359432912224,19,342,15,21,5,0,0,0,16,12,0,6,5,11,0,0,0,0,0,0,0,0
./data/output_files/out/UN_116_em_324.lg, Incorrect,15,7,8,6,2,0.480648903171,8,56,7,7,1,0,0,0,8,6,0,5,1,7,0,0,0,0,0,0,0,0
./data/output_files/out/UN_116_em_325.lg, Incorrect,23,5,18,16,2,0.365428264667,10,90,5,16,1,0,2,1,6,6,0,5,3,3,0,0,0,0,0,0,0,0
./data/output_files/out/UN_116_em_326.lg, Incorrect,8,3,5,3,2,0.601248504944,4,12,2,4,1,0,0,0,3,3,0,1,0,3,0,0,0,0,0,0,0,0
./data/output_files/out/UN_116_em_327.lg, Incorrect,31,5,26,22,4,0.2047240057,20,380,16,23,2,0,2,1,17,14,0,13,13,4,0,0,0,0,0,0,0,0
./data/output_files/out/UN_116_em_328.lg, Incorrect,9,2,7,7,0,0.231320858726,7,42,5,7,0,5,0,0,6,6,0,6,4,2,0,0,0,1,0,0,0,0
./data/output_files/out/UN_116_em_329.lg, Incorrect,31,8,23,19,4,0.277645424939,18,306,13,21,2,0,0,0,14,12,0,11,7,7,0,0,0,0,0,0,0,0
./data/output_files/out/UN_116_em_330.lg, Incorrect,88,19,69,49,20,0.355524622012,30,870,17,59,10,0,0,0,18,18,0,9,7,11,0,0,0,0,0,0,0,0
./data/output_files/out/UN_116_em_331.lg, Incorrect,3,1,2,2,0,0.303561200841,3,6,2,2,0,2,0,0,3,3,0,3,2,1,0,0,0,1,0,0,0,0
./data/output_files/out/UN_116_em_332.lg, Incorrect,31,6,25,11,14,0.459646291361,11,110,6,18,7,0,0,0,7,8,0,4,4,3,0,0,0,0,0,0,0,0
./data/output_files/out/UN_116_em_333.lg, Incorrect,6,2,4,4,0,0.359116756397,4,12,4,4,0,0,0,0,4,3,0,3,2,2,0,0,0,0,0,0,0,0
./data/output_files/out/UN_116_em_334.lg, Incorrect,11,3,8,6,2,0.424865556414,6,30,3,7,1,0,0,0,4,4,0,2,1,3,0,0,0,0,0,0,0,0
./data/output_files/out/UN_116_em_335.lg, Incorrect,4,2,2,2,0,0.414672311952,3,6,2,2,0,0,0,0,3,2,0,2,1,2,0,0,0,0,0,0,0,0
./data/output_files/out/UN_116_em_336.lg, Incorrect,74,9,65,45,20,0.290571493379,25,600,14,52,10,0,6,3,15,18,0,12,12,3,0,0,0,0,0,0,0,0
./data/output_files/out/UN_116_em_337.lg, Incorrect,32,5,27,23,4,0.296852387912,14,182,9,24,2,0,2,1,10,10,0,9,7,3,0,0,0,0,0,0,0,0
./data/output_files/out/UN_116_em_338.lg, Incorrect,5,0,5,5,0,0.166666666667,5,20,3,5,0,5,0,0,4,4,0,4,4,0,0,0,0,1,1,0,0,0
./data/output_files/out/UN_116_em_339.lg, Incorrect,5,2,3,3,0,0.333333333333,4,12,3,3,0,0,0,0,4,3,0,3,2,2,0,0,0,0,0,0,0,0
./data/output_files/out/UN_116_em_340.lg, Incorrect,38,9,29,27,2,0.196653110825,27,702,25,28,1,0,0,0,26,22,0,21,18,8,0,0,0,0,0,0,0,0
./data/output_files/out/UN_116_em_341.lg, Incorrect,7,0,7,7,0,0.136082763488,7,42,5,7,0,7,0,0,6,6,0,6,6,0,0,0,0,1,1,0,0,0
./data/output_files/out/UN_116_em_342.lg, Incorrect,35,6,29,25,4,0.196393395521,23,506,18,27,2,0,0,0,19,18,0,16,13,6,0,0,0,0,0,0,0,0
./data/output_files/out/UN_117_em_343.lg, Incorrect,84,17,67,45,22,0.263584257658,38,1406,24,56,11,0,0,0,25,25,0,15,15,10,0,0,0,0,0,0,0,0
./data/output_files/out/UN_117_em_344.lg, Incorrect,9,0,9,9,0,0.133630620956,8,56,5,9,0,8,0,0,6,6,0,6,6,0,0,0,0,1,1,0,0,0
./data/output_files/out/UN_117_em_345.lg, Incorrect,62,7,55,51,4,0.141361463876,39,1482,30,52,2,0,2,1,31,30,0,28,26,5,0,0,0,0,0,0,0,0
./data/output_files/out/UN_117_em_346.lg, Incorrect,22,4,18,10,8,0.554172674203,7,42,3,14,4,0,0,0,4,3,0,2,2,2,0,0,0,0,0,0,0,0
./data/output_files/out/UN_117_em_347.lg, Incorrect,32,7,25,25,0,0.224906621375,18,306,14,25,0,0,0,0,14,12,0,12,7,7,0,0,0,0,0,0,0,0
./data/output_files/out/UN_117_em_348.lg, Incorrect,24,3,21,21,0,0.151443351116,17,272,11,21,0,0,0,0,12,11,0,11,9,3,0,0,0,0,0,0,0,0
./data/output_files/out/UN_117_em_349.lg, Incorrect,13,4,9,9,0,0.300297287623,8,56,7,9,0,0,0,0,7,6,0,6,3,4,0,0,0,0,0,0,0,0
./data/output_files/out/UN_117_em_350.lg, Incorrect,43,7,36,30,6,0.24854207205,21,420,12,33,3,0,0,0,13,11,0,8,8,5,0,0,0,0,0,0,0,0
./data/output_files/out/UN_117_em_351.lg, Incorrect,12,3,9,9,0,0.228962241309,9,72,7,9,0,0,0,0,8,7,0,7,5,3,0,0,0,0,0,0,0,0
./data/output_files/out/UN_117_em_352.lg, Incorrect,51,9,42,38,4,0.195841345854,30,870,20,40,2,0,0,0,21,17,0,14,14,7,0,0,0,0,0,0,0,0
./data/output_files/out/UN_117_em_353.lg, Incorrect,15,3,12,10,2,0.302749430155,9,72,5,11,1,0,0,0,6,5,0,4,4,2,0,0,0,0,0,0,0,0
./data/output_files/out/UN_117_em_354.lg, Incorrect,23,6,17,17,0,0.200980392157,17,272,15,17,0,0,0,0,16,14,0,14,10,6,0,0,0,0,0,0,0,0
./data/output_files/out/UN_117_em_355.lg, Incorrect,87,15,72,56,16,0.369903159233,25,600,13,62,8,0,4,2,14,17,0,9,7,7,0,0,0,0,0,0,0,0
./data/output_files/out/UN_117_em_356.lg, Incorrect,21,4,17,17,0,0.197113069488,14,182,9,17,0,0,0,0,10,9,0,9,6,4,0,0,0,0,0,0,0,0
./data/output_files/out/UN_117_em_357.lg, Incorrect,38,3,35,35,0,0.151162829778,20,380,11,34,0,0,2,1,12,11,0,11,10,2,0,0,0,0,0,0,0,0
./data/output_files/out/UN_117_em_358.lg, Incorrect,52,10,42,32,10,0.287822354498,23,506,16,37,5,0,0,0,16,17,0,12,10,6,0,0,0,0,0,0,0,0
./data/output_files/out/UN_117_em_359.lg, Incorrect,26,6,20,14,6,0.29254585029,15,210,12,17,3,9,0,0,13,11,0,10,7,6,0,0,0,0,0,0,0,0
./data/output_files/out/UN_117_em_360.lg, Incorrect,33,4,29,27,2,0.19273152992,19,342,12,28,1,0,0,0,13,13,0,12,9,4,0,0,0,0,0,0,0,0
./data/output_files/out/UN_117_em_361.lg, Incorrect,89,18,71,47,24,0.318502350814,33,1056,22,57,12,0,4,2,23,25,0,14,13,10,0,0,0,0,0,0,0,0
./data/output_files/out/UN_117_em_362.lg, Incorrect,39,7,32,28,4,0.247596111751,20,380,12,30,2,0,0,0,13,13,0,10,8,5,0,0,0,0,0,0,0,0
./data/output_files/out/UN_117_em_363.lg, Incorrect,41,6,35,33,2,0.225345371448,20,380,12,33,1,0,2,1,13,13,0,12,9,4,0,0,0,0,0,0,0,0
./data/output_files/out/UN_117_em_364.lg, Incorrect,8,3,5,5,0,0.302749430155,6,30,5,5,0,3,0,0,6,6,0,6,3,3,0,0,0,1,0,0,0,0
./data/output_files/out/UN_117_em_365.lg, Incorrect,8,2,6,6,0,0.315907519168,5,20,2,6,0,3,0,0,3,3,0,3,1,2,0,0,0,1,0,0,0,0
./data/output_files/out/UN_117_em_366.lg, Incorrect,21,4,17,15,2,0.271765035198,12,132,7,16,1,0,0,0,8,7,0,6,5,3,0,0,0,0,0,0,0,0
./data/output_files/out/UN_117_em_367.lg, Incorrect,36,7,29,25,4,0.286518698835,17,272,10,26,2,0,2,1,11,11,0,8,6,5,0,0,0,0,0,0,0,0
./data/output_files/out/UN_118_em_368.lg, Incorrect,48,15,33,29,4,0.382429227029,20,380,14,28,2,0,6,3,15,12,0,10,4,11,0,0,0,0,0,0,0,0
./data/output_files/out/UN_118_em_369.lg, Incorrect,45,8,37,31,6,0.222775913476,25,600,17,33,3,0,2,1,18,15,0,13,13,5,0,0,0,0,0,0,0,0
./data/output_files/out/UN_118_em_370.lg, Incorrect,28,6,22,16,6,0.233957115381,19,342,17,19,3,13,0,0,18,15,0,12,11,7,0,0,0,0,0,0,0,0
./data/output_files/out/UN_118_em_371.lg, Incorrect,29,5,24,18,6,0.300615878848,14,182,8,21,3,0,0,0,9,8,0,8,6,3,0,0,0,0,0,0,0,0
./data/output_files/out/UN_118_em_372.lg, Incorrect,27,7,20,20,0,0.214847961724,18,306,14,20,0,0,0,0,15,14,0,14,8,7,0,0,0,0,0,0,0,0
./data/output_files/out/UN_118_em_373.lg, Incorrect,40,7,33,19,14,0.469667602324,12,132,5,26,7,0,0,0,6,8,0,3,3,3,0,0,0,0,0,0,0,0
./data/output_files/out/UN_118_em_374.lg, Incorrect,32,1,31,31,0,0.0823929203408,27,702,21,31,0,0,0,0,22,21,0,21,21,1,0,0,0,0,0,0,0,0
./data/output_files/out/UN_118_em_375.lg, Incorrect,17,2,15,13,2,0.281774784492,9,72,5,14,1,0,0,0,6,6,0,5,5,1,0,0,0,0,0,0,0,0
./data/output_files/out/UN_118_em_376.lg, Incorrect,23,4,19,13,6,0.263461877281,14,182,11,16,3,0,0,0,12,11,0,11,10,2,0,0,0,0,0,0,0,0
./data/output_files/out/UN_118_em_377.lg, Incorrect,8,2,6,6,0,0.402368927062,4,12,2,5,0,2,2,1,3,3,0,3,2,1,0,0,0,1,0,0,0,0
./data/output_files/out/UN_118_em_378.lg, Incorrect,15,3,12,10,2,0.27140652339,10,90,8,11,1,7,0,0,9,10,0,8,7,2,0,0,0,0,0,0,0,0
./data/output_files/out/UN_118_em_379.lg, Incorrect,14,3,11,11,0,0.179558378198,12,132,11,11,0,0,0,0,12,11,0,11,9,3,0,0,0,0,0,0,0,0
./data/output_files/out/UN_118_em_380.lg, Incorrect,35,6,29,21,8,0.267624377251,18,306,13,25,4,0,0,0,14,13,0,10,10,4,0,0,0,0,0,0,0,0
./data/output_files/out/UN_118_em_381.lg, Incorrect,44,10,34,28,6,0.324690264274,19,342,13,31,3,0,0,0,14,15,0,9,7,7,0,0,0,0,0,0,0,0
./data/output_files/out/UN_118_em_382.lg, Incorrect,28,8,20,10,10,0.67339714401,8,56,3,15,5,0,0,0,4,6,0,1,0,4,0,0,0,0,0,0,0,0
./data/output_files/out/UN_118_em_383.lg, Incorrect,69,12,57,41,16,0.317173338778,25,600,15,47,8,0,4,2,16,15,0,12,8,8,0,0,0,0,0,0,0,0
./data/output_files/out/UN_118_em_384.lg, Incorrect,26,2,24,24,0,0.130389042639,18,306,13,24,0,0,0,0,14,12,0,12,12,2,0,0,0,0,0,0,0,0
./data/output_files/out/UN_118_em_385.lg, Incorrect,17,4,13,13,0,0.327270685277,8,56,5,11,0,4,4,2,6,6,0,6,4,2,0,0,0,1,0,0,0,0
./data/output_files/out/UN_118_em_386.lg, Incorrect,9,4,5,5,0,0.35830498571,6,30,5,5,0,0,0,0,6,4,0,4,2,4,0,0,0,0,0,0,0,0
./data/output_files/out/UN_118_em_387.lg, Incorrect,58,8,50,40,10,0.293429503529,21,420,12,44,5,0,2,1,13,13,0,10,8,5,0,0,0,0,0,0,0,0
./data/output_files/out/UN_118_em_388.lg, Incorrect,26,6,20,16,4,0.282206603931,15,210,12,17,2,0,2,1,13,13,0,11,9,4,0,0,0,0,0,0,0,0
./data/output_files/out/UN_118_em_389.lg, Incorrect,14,1,13,13,0,0.202270685277,8,56,6,13,0,7,0,0,6,6,0,6,5,1,0,0,0,1,0,0,0,0
./data/output_files/out/UN_118_em_390.lg, Incorrect,66,15,51,45,6,0.211250384377,39,1482,32,47,3,0,2,1,33,28,0,26,20,13,0,0,0,0,0,0,0,0
./data/output_files/out/UN_118_em_391.lg, Incorrect,36,8,28,22,6,0.35583751865,15,210,11,25,3,0,0,0,11,10,0,10,5,6,0,0,0,0,0,0,0,0
./data/output_files/out/UN_118_em_392.lg, Incorrect,48,7,41,29,12,0.2716015516,21,420,15,34,6,0,2,1,15,17,0,13,11,4,0,0,0,0,0,0,0,0
./data/output_files/out/UN_119_em_393.lg, Incorrect,9,1,8,6,2,0.313754445303,6,30,3,7,1,5,0,0,4,5,0,3,3,1,0,0,0,0,0,0,0,0
./data/output_files/out/UN_119_em_394.lg, Incorrect,11,1,10,8,2,0.334071941868,6,30,2,9,1,0,0,0,3,3,0,2,2,1,0,0,0,0,0,0,0,0
./data/output_files/out/UN_119_em_395.lg, Incorrect,12,2,10,8,2,0.25385562838,9,72,9,9,1,0,0,0,9,7,0,6,6,3,0,0,0,0,0,0,0,0
./data/output_files/out/UN_119_em_396.lg, Incorrect,31,7,24,16,8,0.457714315949,11,110,6,20,4,0,0,0,7,7,0,4,3,4,0,0,0,0,0,0,0,0
./data/output_files/out/UN_119_em_397.lg, Incorrect,48,7,41,41,0,0.121544570853,37,1332,29,41,0,0,0,0,30,27,0,27,23,7,0,0,0,0,0,0,0,0
./data/output_files/out/UN_119_em_398.lg, Incorrect,16,3,13,11,2,0.250447690232,11,110,10,12,1,8,0,0,10,9,0,8,6,4,0,0,0,0,0,0,0,0
./data/output_files/out/UN_119_em_399.lg, Incorrect,9,3,6,6,0,0.485702260396,4,12,2,5,0,0,2,1,3,2,0,2,1,2,0,0,0,0,0,0,0,0
./data/output_files/out/UN_119_em_400.lg, Incorrect,9,3,6,6,0,0.485702260396,4,12,2,5,0,1,2,1,3,3,0,3,1,2,0,0,0,1,0,0,0,0
./data/output_files/out/UN_119_em_401.lg, Incorrect,34,5,29,19,10,0.423170705725,11,110,5,23,5,0,2,1,6,7,0,4,4,2,0,0,0,0,0,0,0,0
./data/output_files/out/UN_119_em_402.lg, Incorrect,6,1,5,5,0,0.191638319044,6,30,5,5,0,5,0,0,6,6,0,6,5,1,0,0,0,1,0,0,0,0
./data/output_files/out/UN_119_em_403.lg, Incorrect,71,14,57,41,16,0.330494438883,26,650,17,48,8,0,2,1,17,18,0,10,8,9,0,0,0,0,0,0,0,0
./data/output_files/out/UN_119_em_404.lg, Incorrect,36,8,28,20,8,0.302876644042,18,306,14,24,4,0,0,0,15,16,0,10,8,7,0,0,0,0,0,0,0,0
./data/output_files/out/UN_119_em_405.lg, Incorrect,3,1,2,2,0,0.303561200841,3,6,2,2,0,2,0,0,3,3,0,3,2,1,0,0,0,1,0,0,0,0
./data/output_files/out/UN_119_em_406.lg, Incorrect,45,10,35,27,8,0.300959574218,21,420,13,31,4,0,0,0,14,15,0,11,6,8,0,0,0,0,0,0,0,0
./data/output_files/out/UN_119_em_407.lg, Incorrect,26,6,20,8,12,0.816317370987,6,30,2,14,6,0,0,0,3,4,0,1,0,3,0,0,0,0,0,0,0,0
./data/output_files/out/UN_119_em_408.lg, Incorrect,34,8,26,16,10,0.504985502218,11,110,6,20,5,0,2,1,7,7,0,4,2,5,0,0,0,0,0,0,0,0
./data/output_files/out/UN_119_em_409.lg, Incorrect,13,3,10,10,0,0.235337109861,9,72,8,10,0,0,0,0,8,7,0,7,5,3,0,0,0,0,0,0,0,0
./data/output_files/out/UN_119_em_410.lg, Incorrect,23,2,21,19,2,0.182383702215,15,210,9,20,1,0,0,0,10,10,0,8,8,2,0,0,0,0,0,0,0,0
./data/output_files/out/UN_119_em_411.lg, Incorrect,48,7,41,35,6,0.177821685305,30,870,23,38,3,0,0,0,24,23,0,20,19,5,0,0,0,0,0,0,0,0
./data/output_files/out/UN_119_em_412.lg, Incorrect,38,4,34,32,2,0.181334688462,21,420,12,33,1,0,0,0,13,13,0,11,10,3,0,0,0,0,0,0,0,0
./data/output_files/out/UN_119_em_413.lg, Incorrect,3,0,3,3,0,0.166666666667,4,12,2,3,0,4,0,0,3,3,0,3,3,0,0,0,0,1,1,0,0,0
./data/output_files/out/UN_119_em_414.lg, Incorrect,2,0,2,2,0,0.19245008973,3,6,1,2,0,3,0,0,2,2,0,2,2,0,0,0,0,1,1,0,0,0
./data/output_files/out/UN_119_em_415.lg, Incorrect,17,3,14,12,2,0.313652850615,9,72,5,13,1,0,0,0,6,6,0,4,4,2,0,0,0,0,0,0,0,0
./data/output_files/out/UN_119_em_416.lg, Incorrect,40,9,31,19,12,0.437447863764,14,182,8,24,6,0,2,1,9,8,0,4,3,6,0,0,0,0,0,0,0,0
./data/output_files/out/UN_119_em_417.lg, Incorrect,10,2,8,6,2,0.369310000858,6,30,4,7,1,0,0,0,5,4,0,4,4,1,0,0,0,0,0,0,0,0
./data/output_files/out/UN_120_em_418.lg, Incorrect,34,0,34,34,0,0.0997071736027,20,380,11,34,0,20,0,0,12,12,0,12,12,0,0,0,0,1,1,0,0,0
./data/output_files/out/UN_120_em_419.lg, Incorrect,4,0,4,4,0,0.19245008973,4,12,2,4,0,4,0,0,3,3,0,3,3,0,0,0,0,1,1,0,0,0
./data/output_files/out/UN_120_em_420.lg, Incorrect,16,6,10,10,0,0.390859042455,8,56,6,9,0,0,2,1,7,4,0,4,2,5,0,0,0,0,0,0,0,0
./data/output_files/out/UN_120_em_421.lg, Incorrect,13,3,10,8,2,0.290892665417,9,72,5,9,1,6,0,0,6,7,0,5,4,2,0,0,0,0,0,0,0,0
./data/output_files/out/UN_120_em_422.lg, Incorrect,61,17,44,40,4,0.277160834288,31,930,24,38,2,0,8,4,25,25,0,23,12,13,0,0,0,0,0,0,0,0
./data/output_files/out/UN_120_em_423.lg, Incorrect,14,1,13,13,0,0.17867646797,9,72,5,13,0,0,0,0,6,5,0,5,5,1,0,0,0,0,0,0,0,0
./data/output_files/out/UN_120_em_424.lg, Incorrect,30,6,24,22,2,0.278550569729,15,210,9,23,1,0,0,0,10,8,0,6,5,5,0,0,0,0,0,0,0,0
./data/output_files/out/UN_120_em_425.lg, Incorrect,4,1,3,3,0,0.25,4,12,2,3,0,0,0,0,3,2,0,2,2,1,0,0,0,0,0,0,0,0
./data/output_files/out/UN_120_em_426.lg, Incorrect,4,1,3,3,0,0.25,4,12,2,3,0,3,0,0,3,3,0,3,2,1,0,0,0,1,0,0,0,0
./data/output_files/out/UN_120_em_427.lg, Incorrect,19,2,17,17,0,0.17517898265,12,132,8,16,0,10,2,1,9,9,0,9,8,1,0,0,0,1,0,0,0,0
./data/output_files/out/UN_120_em_428.lg, Incorrect,11,1,10,10,0,0.144444444444,10,90,8,10,0,9,0,0,9,9,0,9,8,1,0,0,0,1,0,0,0,0
./data/output_files/out/UN_120_em_429.lg, Incorrect,49,4,45,43,2,0.170793237857,24,552,15,44,1,20,0,0,16,17,0,15,11,5,0,0,0,0,0,0,0,0
./data/output_files/out/UN_120_em_430.lg, Incorrect,12,1,11,11,0,0.149867649797,10,90,9,11,0,9,0,0,9,9,0,9,8,1,0,0,0,1,0,0,0,0
./data/output_files/out/UN_120_em_431.lg, Incorrect,16,3,13,11,2,0.228971482737,12,132,9,12,1,0,0,0,10,9,0,8,8,2,0,0,0,0,0,0,0,0
./data/output_files/out/UN_120_em_432.lg, Incorrect,35,5,30,20,10,0.389546300857,12,132,5,24,5,0,2,1,6,7,0,4,4,2,0,0,0,0,0,0,0,0
./data/output_files/out/UN_120_em_433.lg, Incorrect,8,2,6,6,0,0.402368927062,4,12,2,5,0,2,2,1,3,3,0,3,2,1,0,0,0,1,0,0,0,0
./data/output_files/out/UN_120_em_434.lg, Incorrect,3,1,2,2,0,0.303561200841,3,6,2,2,0,2,0,0,3,3,0,3,2,1,0,0,0,1,0,0,0,0
./data/output_files/out/UN_120_em_435.lg, Incorrect,24,4,20,10,10,0.686837838928,6,30,2,14,5,0,2,1,3,3,0,2,2,1,0,0,0,0,0,0,0,0
./data/output_files/out/UN_120_em_436.lg, Incorrect,21,7,14,12,2,0.344031432651,12,132,10,13,1,0,0,0,11,9,0,7,5,6,0,0,0,0,0,0,0,0
./data/output_files/out/UN_120_em_437.lg, Incorrect,32,7,25,21,4,0.224966119622,21,420,18,23,2,0,0,0,19,17,0,15,12,7,0,0,0,0,0,0,0,0
./data/output_files/out/UN_120_em_438.lg, Incorrect,31,9,22,16,6,0.364233429477,15,210,11,19,3,0,0,0,12,8,0,5,5,7,0,0,0,0,0,0,0,0
./data/output_files/out/UN_120_em_439.lg, Incorrect,9,1,8,8,0,0.22768814872,6,30,2,8,0,5,0,0,3,3,0,3,2,1,0,0,0,1,0,0,0,0
./data/output_files/out/UN_120_em_440.lg, Incorrect,24,2,22,20,2,0.137720292201,20,380,16,21,1,18,0,0,17,18,0,16,16,1,0,0,0,0,0,0,0,0
./data/output_files/out/UN_120_em_441.lg, Incorrect,30,7,23,13,10,0.571883313096,9,72,5,17,5,0,2,1,6,5,0,3,2,4,0,0,0,0,0,0,0,0
./data/output_files/out/UN_120_em_442.lg, Incorrect,8,4,4,4,0,0.415737865167,5,20,4,4,0,0,0,0,5,4,0,4,1,4,0,0,0,0,0,0,0,0
./data/output_files/out/UN_121_em_443.lg, Incorrect,71,12,59,41,18,0.384416591338,21,420,11,47,9,0,6,3,12,12,0,8,7,5,0,0,0,0,0,0,0,0
./data/output_files/out/UN_121_em_444.lg, Incorrect,37,8,29,19,10,0.374387633349,15,210,8,24,5,0,0,0,9,10,0,5,5,4,0,0,0,0,0,0,0,0
./data/output_files/out/UN_121_em_445.lg, Incorrect,46,7,39,37,2,0.214947103878,23,506,15,36,1,0,4,2,16,15,0,14,12,4,0,0,0,0,0,0,0,0
./data/output_files/out/UN_121_em_446.lg, Incorrect,42,7,35,27,8,0.296259692126,18,306,11,31,4,0,0,0,12,10,0,8,8,4,0,0,0,0,0,0,0,0
./data/output_files/out/UN_121_em_447.lg, Incorrect,25,4,21,19,2,0.188345282188,18,306,15,20,1,0,0,0,16,16,0,14,13,3,0,0,0,0,0,0,0,0
./data/output_files/out/UN_121_em_448.lg, Incorrect,38,5,33,27,6,0.248733524965,18,306,11,30,3,0,0,0,12,11,0,11,9,3,0,0,0,0,0,0,0,0
./data/output_files/out/UN_121_em_449.lg, Incorrect,75,12,63,53,10,0.235066945629,33,1056,21,56,5,0,4,2,22,22,0,17,15,7,0,0,0,0,0,0,0,0
./data/output_files/out/UN_121_em_450.lg, Incorrect,13,1,12,12,0,0.155049457223,10,90,6,12,0,9,0,0,7,7,0,7,6,1,0,0,0,1,0,0,0,0
./data/output_files/out/UN_121_em_451.lg, Incorrect,16,4,12,12,0,0.211614892637,12,132,10,12,0,0,0,0,11,10,0,10,7,4,0,0,0,0,0,0,0,0
./data/output_files/out/UN_121_em_452.lg, Incorrect,30,5,25,23,2,0.193014071011,20,380,14,24,1,0,0,0,15,14,0,12,11,4,0,0,0,0,0,0,0,0
./data/output_files/out/UN_121_em_453.lg, Incorrect,25,5,20,8,12,0.561841451518,8,56,3,14,6,3,0,0,4,7,0,3,2,2,0,0,0,0,0,0,0,0
./data/output_files/out/UN_121_em_454.lg, Incorrect,21,2,19,19,0,0.127314709586,17,272,13,19,0,15,0,0,14,14,0,14,12,2,0,0,0,1,0,0,0,0
./data/output_files/out/UN_121_em_455.lg, Incorrect,8,1,7,7,0,0.183701811107,7,42,5,7,0,6,0,0,6,6,0,6,5,1,0,0,0,1,0,0,0,0
./data/output_files/out/UN_121_em_456.lg, Incorrect,9,3,6,6,0,0.485702260396,4,12,2,5,0,0,2,1,3,2,0,2,1,2,0,0,0,0,0,0,0,0
./data/output_files/out/UN_121_em_457.lg, Incorrect,27,7,20,8,12,0.571024114979,9,72,4,14,6,0,0,0,5,3,0,3,2,3,0,0,0,0,0,0,0,0
./data/output_files/out/UN_121_em_458.lg, Incorrect,14,2,12,12,0,0.143732083986,13,156,11,12,0,11,0,0,12,12,0,12,10,2,0,0,0,1,0,0,0,0
./data/output_files/out/UN_121_em_459.lg, Incorrect,26,6,20,16,4,0.282206603931,15,210,12,18,2,9,0,0,13,15,0,11,9,4,0,0,0,0,0,0,0,0
./data/output_files/out/UN_121_em_460.lg, Incorrect,10,2,8,8,0,0.185185185185,9,72,8,8,0,0,0,0,9,8,0,8,7,2,0,0,0,0,0,0,0,0
./data/output_files/out/UN_121_em_461.lg, Incorrect,53,9,44,34,10,0.19138792866,33,1056,23,39,5,0,0,0,24,22,0,18,16,8,0,0,0,0,0,0,0,0
./data/output_files/out/UN_121_em_462.lg, Incorrect,17,3,14,12,2,0.281158839124,10,90,5,13,1,0,0,0,6,5,0,4,3,3,0,0,0,0,0,0,0,0
./data/output_files/out/UN_121_em_463.lg, Incorrect,17,1,16,14,2,0.184860045408,12,132,8,15,1,0,0,0,9,9,0,8,8,1,0,0,0,0,0,0,0,0
./data/output_files/out/UN_121_em_464.lg, Incorrect,26,7,19,5,14,0.65249412417,8,56,6,12,7,0,0,0,7,4,0,3,1,6,0,0,0,0,0,0,0,0
./data/output_files/out/UN_121_em_465.lg, Incorrect,5,0,5,5,0,0.136082763488,6,30,5,5,0,6,0,0,6,6,0,6,6,0,0,0,0,1,1,0,0,0
./data/output_files/out/UN_121_em_466.lg, Incorrect,4,0,4,4,0,0.19245008973,4,12,2,4,0,4,0,0,3,3,0,3,3,0,0,0,0,1,1,0,0,0
./data/output_files/out/UN_121_em_467.lg, Incorrect,18,3,15,9,6,0.551440125562,6,30,2,12,3,0,0,0,3,4,0,2,2,1,0,0,0,0,0,0,0,0
./data/output_files/out/UN_122_em_468.lg, Incorrect,22,3,19,15,4,0.293008165958,11,110,7,16,2,0,2,1,8,8,0,7,7,1,0,0,0,0,0,0,0,0
./data/output_files/out/UN_122_em_469.lg, Incorrect,63,16,47,27,20,0.418096413266,22,462,15,37,10,0,0,0,16,19,0,13,6,10,0,0,0,0,0,0,0,0
./data/output_files/out/UN_122_em_470.lg, Incorrect,33,7,26,20,6,0.308251392437,16,240,9,23,3,0,0,0,10,8,0,8,5,5,0,0,0,0,0,0,0,0
./data/output_files/out/UN_122_em_471.lg, Incorrect,24,6,18,14,4,0.29710224764,14,182,12,16,2,0,0,0,12,10,0,8,6,6,0,0,0,0,0,0,0,0
./data/output_files/out/UN_122_em_472.lg, Incorrect,7,1,6,6,0,0.204626754056,6,30,3,6,0,5,0,0,4,4,0,4,3,1,0,0,0,1,0,0,0,0
./data/output_files/out/UN_122_em_473.lg, Incorrect,173,35,138,90,48,0.332412990226,54,2862,34,109,24,0,10,5,35,38,0,23,15,20,0,0,0,0,0,0,0,0
./data/output_files/out/UN_122_em_474.lg, Incorrect,22,8,14,14,0,0.304985653381,13,156,11,13,0,0,2,1,12,8,0,8,5,7,0,0,0,0,0,0,0,0
./data/output_files/out/UN_122_em_475.lg, Incorrect,57,12,45,33,12,0.373942754711,20,380,13,38,6,0,2,1,14,11,0,8,6,8,0,0,0,0,0,0,0,0
./data/output_files/out/UN_122_em_476.lg, Incorrect,17,4,13,11,2,0.390264764111,8,56,5,12,1,0,0,0,6,6,0,5,3,3,0,0,0,0,0,0,0,0
./data/output_files/out/UN_122_em_477.lg, Incorrect,50,8,42,32,10,0.462481326273,13,156,5,34,5,0,6,3,6,8,0,3,3,3,0,0,0,0,0,0,0,0
./data/output_files/out/UN_122_em_478.lg, Incorrect,38,4,34,32,2,0.151927547068,25,600,17,33,1,0,0,0,18,18,0,16,15,3,0,0,0,0,0,0,0,0
./data/output_files/out/UN_122_em_479.lg, Incorrect,3,2,1,1,0,0.569035593729,2,2,1,1,0,0,0,0,2,1,0,1,0,2,0,0,0,0,0,0,0,0
./data/output_files/out/UN_122_em_480.lg, Incorrect,31,7,24,16,8,0.504846725498,10,90,5,20,4,3,0,0,6,9,0,4,2,4,0,0,0,0,0,0,0,0
./data/output_files/out/UN_122_em_481.lg, Incorrect,6,0,6,6,0,0.182574185835,5,20,2,6,0,5,0,0,3,3,0,3,3,0,0,0,0,1,1,0,0,0
./data/output_files/out/UN_122_em_482.lg, Incorrect,23,6,17,5,12,0.795076061581,6,30,2,11,6,0,0,0,3,4,0,1,0,3,0,0,0,0,0,0,0,0
./data/output_files/out/UN_122_em_483.lg, Incorrect,14,3,11,11,0,0.272734210071,8,56,5,11,0,0,0,0,6,4,0,4,3,3,0,0,0,0,0,0,0,0
./data/output_files/out/UN_122_em_484.lg, Incorrect,58,8,50,46,4,0.230108264229,25,600,16,48,2,0,0,0,17,17,0,15,11,6,0,0,0,0,0,0,0,0
./data/output_files/out/UN_122_em_485.lg, Incorrect,23,3,20,18,2,0.177794317693,17,272,13,19,1,0,0,0,14,14,0,12,12,2,0,0,0,0,0,0,0,0
./data/output_files/out/UN_122_em_486.lg, Incorrect,51,9,42,36,6,0.200921055685,30,870,24,39,3,0,0,0,25,24,0,18,18,7,0,0,0,0,0,0,0,0
./data/output_files/out/UN_122_em_487.lg, Incorrect,49,14,35,31,4,0.253519520319,29,812,24,32,2,0,2,1,25,16,0,14,11,14,0,0,0,0,0,0,0,0
./data/output_files/out/UN_122_em_488.lg, Incorrect,10,2,8,6,2,0.44956109935,5,20,2,7,1,3,0,0,3,4,0,2,2,1,0,0,0,0,0,0,0,0
./data/output_files/out/UN_122_em_489.lg, Incorrect,20,5,15,11,4,0.41589776018,9,72,5,13,2,4,0,0,6,8,0,4,3,3,0,0,0,0,0,0,0,0
./data/output_files/out/UN_122_em_490.lg, Incorrect,125,39,86,46,40,0.357865250642,51,2550,41,66,20,0,0,0,42,35,0,21,8,34,0,0,0,0,0,0,0,0
./data/output_files/out/UN_122_em_491.lg, Incorrect,11,2,9,7,2,0.379751593529,6,30,3,8,1,4,0,0,4,5,0,3,3,1,0,0,0,0,0,0,0,0
./data/output_files/out/UN_122_em_492.lg, Incorrect,9,2,7,7,0,0.231320858726,7,42,5,7,0,0,0,0,6,5,0,5,4,2,0,0,0,0,0,0,0,0
./data/output_files/out/UN_123_em_493.lg, Incorrect,25,4,21,21,0,0.194298144228,15,210,10,19,0,11,4,2,11,11,0,11,9,2,0,0,0,1,0,0,0,0
./data/output_files/out/UN_123_em_494.lg, Incorrect,40,7,33,15,18,0.736532061031,8,56,2,24,9,0,0,0,3,7,0,1,1,2,0,0,0,0,0,0,0,0
./data/output_files/out/UN_123_em_495.lg, Incorrect,25,4,21,17,4,0.199507676105,18,306,15,19,2,14,0,0,16,14,0,12,11,5,0,0,0,0,0,0,0,0
./data/output_files/out/UN_123_em_496.lg, Incorrect,4,2,2,2,0,0.414672311952,3,6,2,2,0,1,0,0,3,3,0,3,1,2,0,0,0,1,0,0,0,0
./data/output_files/out/UN_123_em_497.lg, Incorrect,21,8,13,13,0,0.493937351943,8,56,5,10,0,0,6,3,6,6,0,6,0,6,0,0,0,1,0,0,0,0
./data/output_files/out/UN_123_em_498.lg, Incorrect,27,4,23,17,6,0.387907973117,10,90,6,20,3,6,0,0,6,8,0,5,4,2,0,0,0,0,0,0,0,0
./data/output_files/out/UN_123_em_499.lg, Incorrect,10,2,8,8,0,0.240716688729,7,42,6,8,0,0,0,0,6,5,0,5,4,2,0,0,0,0,0,0,0,0
./data/output_files/out/UN_123_em_500.lg, Incorrect,17,3,14,14,0,0.176780525176,13,156,10,14,0,0,0,0,11,8,0,8,8,3,0,0,0,0,0,0,0,0
./data/output_files/out/UN_123_em_501.lg, Incorrect,47,5,42,36,6,0.236037051863,20,380,13,38,3,0,2,1,13,10,0,9,9,4,0,0,0,0,0,0,0,0
./data/output_files/out/UN_123_em_502.lg, Incorrect,69,11,58,50,8,0.171196835074,42,1722,33,53,4,0,2,1,34,34,0,30,26,8,0,0,0,0,0,0,0,0
./data/output_files/out/UN_123_em_503.lg, Incorrect,80,20,60,50,10,0.26539181055,39,1482,28,52,5,0,6,3,29,29,0,23,15,14,0,0,0,0,0,0,0,0
./data/output_files/out/UN_123_em_504.lg, Incorrect,51,9,42,20,22,0.341022744898,20,380,13,30,11,0,2,1,14,10,0,7,7,7,0,0,0,0,0,0,0,0
./data/output_files/out/UN_123_em_505.lg, Incorrect,47,10,37,35,2,0.202639956747,29,812,23,35,1,0,2,1,24,24,0,22,16,8,0,0,0,0,0,0,0,0
./data/output_files/out/UN_123_em_506.lg, Incorrect,24,3,21,21,0,0.184656274843,14,182,8,21,0,0,0,0,9,7,0,7,6,3,0,0,0,0,0,0,0,0
./data/output_files/out/UN_123_em_507.lg, Incorrect,4,0,4,4,0,0.19245008973,4,12,2,4,0,4,0,0,3,3,0,3,3,0,0,0,0,1,1,0,0,0
./data/output_files/out/UN_123_em_508.lg, Incorrect,17,5,12,10,2,0.574662585038,6,30,3,10,1,1,2,1,4,5,0,3,1,3,0,0,0,0,0,0,0,0
./data/output_files/out/UN_123_em_509.lg, Incorrect,9,3,6,2,4,0.678152350125,4,12,2,4,2,1,0,0,3,3,0,1,1,2,0,0,0,0,0,0,0,0
./data/output_files/out/UN_123_em_510.lg, Incorrect,8,2,6,6,0,0.402368927062,4,12,2,5,0,2,2,1,3,3,0,3,2,1,0,0,0,1,0,0,0,0
./data/output_files/out/UN_123_em_511.lg, Incorrect,54,10,44,24,20,0.42053273322,17,272,9,33,10,0,2,1,10,10,0,4,4,6,0,0,0,0,0,0,0,0
./data/output_files/out/UN_123_em_512.lg, Incorrect,58,15,43,33,10,0.296405648542,28,756,21,37,5,0,2,1,22,21,0,14,12,10,0,0,0,0,0,0,0,0
./data/output_files/out/UN_123_em_513.lg, Incorrect,20,6,14,10,4,0.682759474245,6,30,2,11,2,0,2,1,3,5,0,1,0,3,0,0,0,0,0,0,0,0
./data/output_files/out/UN_123_em_514.lg, Incorrect,12,0,12,12,0,0.12171612389,10,90,6,12,0,10,0,0,7,7,0,7,7,0,0,0,0,1,1,0,0,0
./data/output_files/out/UN_123_em_515.lg, Incorrect,20,5,15,13,2,0.292286029626,12,132,8,14,1,0,0,0,9,7,0,6,5,4,0,0,0,0,0,0,0,0
./data/output_files/out/UN_123_em_516.lg, Incorrect,15,3,12,10,2,0.302749430155,9,72,6,11,1,0,0,0,7,6,0,5,5,2,0,0,0,0,0,0,0,0
./data/output_files/out/UN_123_em_517.lg, Incorrect,18,3,15,9,6,0.551440125562,6,30,2,12,3,3,0,0,3,5,0,2,2,1,0,0,0,0,0,0,0,0
./data/output_files/out/UN_124_em_518.lg, Incorrect,14,0,14,14,0,0.166666666667,8,56,3,14,0,8,0,0,4,4,0,4,4,0,0,0,0,1,1,0,0,0
./data/output_files/out/UN_124_em_519.lg, Incorrect,3,0,3,3,0,0.166666666667,4,12,3,3,0,4,0,0,4,4,0,4,4,0,0,0,0,1,1,0,0,0
./data/output_files/out/UN_124_em_520.lg, Incorrect,80,11,69,47,22,0.29931635221,27,702,14,58,11,0,0,0,15,17,0,7,7,8,0,0,0,0,0,0,0,0
./data/output_files/out/UN_124_em_521.lg, Incorrect,24,2,22,22,0,0.113537750531,20,380,14,22,0,0,0,0,15,13,0,13,13,2,0,0,0,0,0,0,0,0
./data/output_files/out/UN_124_em_522.lg, Incorrect,24,4,20,16,4,0.326910104732,11,110,5,18,2,0,0,0,6,6,0,4,4,2,0,0,0,0,0,0,0,0
./data/output_files/out/UN_124_em_523.lg, Incorrect,4,1,3,3,0,0.25,4,12,3,3,0,3,0,0,4,4,0,4,3,1,0,0,0,1,0,0,0,0
./data/output_files/out/UN_124_em_524.lg, Incorrect,11,2,9,7,2,0.462349386422,5,20,4,8,1,3,0,0,4,5,0,3,3,1,0,0,0,0,0,0,0,0
./data/output_files/out/UN_124_em_525.lg, Incorrect,4,2,2,2,0,0.414672311952,3,6,2,2,0,1,0,0,3,3,0,3,1,2,0,0,0,1,0,0,0,0
./data/output_files/out/UN_124_em_526.lg, Incorrect,22,2,20,18,2,0.27349190643,10,90,6,19,1,0,0,0,6,6,0,5,4,2,0,0,0,0,0,0,0,0
./data/output_files/out/UN_124_em_527.lg, Incorrect,32,7,25,23,2,0.251855024157,18,306,13,23,1,0,2,1,14,13,0,11,8,6,0,0,0,0,0,0,0,0
./data/output_files/out/UN_124_em_528.lg, Incorrect,26,2,24,22,2,0.219768709179,13,156,7,23,1,0,0,0,7,7,0,6,6,1,0,0,0,0,0,0,0,0
./data/output_files/out/UN_124_em_529.lg, Incorrect,60,13,47,29,18,0.479212959484,17,272,8,36,9,0,4,2,9,11,0,3,3,6,0,0,0,0,0,0,0,0
./data/output_files/out/UN_124_em_530.lg, Incorrect,14,4,10,8,2,0.370519787956,8,56,6,9,1,0,0,0,7,5,0,4,4,3,0,0,0,0,0,0,0,0
./data/output_files/out/UN_124_em_531.lg, Incorrect,4,1,3,3,0,0.25,4,12,3,3,0,0,0,0,4,3,0,3,3,1,0,0,0,0,0,0,0,0
./data/output_files/out/UN_124_em_532.lg, Incorrect,35,12,23,21,2,0.473426150129,13,156,8,19,1,0,6,3,9,8,0,7,1,8,0,0,0,0,0,0,0,0
./data/output_files/out/UN_124_em_533.lg, Incorrect,39,5,34,30,4,0.160248472684,27,702,20,32,2,22,0,0,21,21,0,18,16,5,0,0,0,0,0,0,0,0
./data/output_files/out/UN_124_em_534.lg, Incorrect,7,2,5,5,0,0.3,5,20,3,5,0,0,0,0,4,3,0,3,2,2,0,0,0,0,0,0,0,0
./data/output_files/out/UN_124_em_535.lg, Incorrect,51,14,37,29,8,0.307932598089,25,600,20,33,4,0,0,0,20,14,0,10,8,12,0,0,0,0,0,0,0,0
./data/output_files/out/UN_124_em_536.lg, Incorrect,8,1,7,7,0,0.183701811107,7,42,5,7,0,6,0,0,6,6,0,6,5,1,0,0,0,1,0,0,0,0
./data/output_files/out/UN_124_em_537.lg, Incorrect,42,8,34,26,8,0.281405590277,20,380,14,29,4,12,2,1,15,18,0,12,10,5,0,0,0,0,0,0,0,0
./data/output_files/out/UN_124_em_538.lg, Incorrect,37,9,28,22,6,0.268764393084,21,420,18,25,3,0,0,0,19,15,0,12,11,8,0,0,0,0,0,0,0,0
./data/output_files/out/UN_124_em_539.lg, Incorrect,14,0,14,14,0,0.166666666667,8,56,3,14,0,8,0,0,4,4,0,4,4,0,0,0,0,1,1,0,0,0
./data/output_files/out/UN_124_em_540.lg, Incorrect,72,11,61,43,18,0.242143217235,32,992,23,51,9,0,2,1,23,20,0,15,14,9,0,0,0,0,0,0,0,0
./data/output_files/out/UN_124_em_541.lg, Incorrect,41,9,32,24,8,0.295095250022,20,380,13,28,4,0,0,0,14,11,0,8,7,7,0,0,0,0,0,0,0,0
./data/output_files/out/UN_124_em_542.lg, Incorrect,19,3,16,12,4,0.281601608758,11,110,7,14,2,0,0,0,8,8,0,6,6,2,0,0,0,0,0,0,0,0
./data/output_files/out/UN_125_em_543.lg, Incorrect,28,5,23,13,10,0.446286120979,10,90,4,17,5,0,2,1,5,6,0,3,3,2,0,0,0,0,0,0,0,0
./data/output_files/out/UN_125_em_544.lg, Incorrect,13,0,13,13,0,0.141639430933,9,72,5,13,0,9,0,0,6,6,0,6,6,0,0,0,0,1,1,0,0,0
./data/output_files/out/UN_125_em_545.lg, Incorrect,27,5,22,22,0,0.172262177163,19,342,15,22,0,0,0,0,16,14,0,14,11,5,0,0,0,0,0,0,0,0
./data/output_files/out/UN_125_em_546.lg, Incorrect,45,8,37,35,2,0.217475275442,24,552,16,34,1,0,4,2,17,16,0,15,12,5,0,0,0,0,0,0,0,0
./data/output_files/out/UN_125_em_547.lg, Incorrect,11,3,8,8,0,0.222222222222,9,72,8,8,0,6,0,0,9,9,0,9,6,3,0,0,0,1,0,0,0,0
./data/output_files/out/UN_125_em_548.lg, Incorrect,44,8,36,30,6,0.221649658093,25,600,19,33,3,0,0,0,20,18,0,15,14,6,0,0,0,0,0,0,0,0
./data/output_files/out/UN_125_em_549.lg, Incorrect,36,6,30,30,0,0.175850289482,22,462,16,29,0,0,2,1,17,16,0,16,12,5,0,0,0,0,0,0,0,0
./data/output_files/out/UN_125_em_550.lg, Incorrect,13,2,11,9,2,0.29406162224,8,56,4,10,1,0,0,0,5,5,0,4,4,1,0,0,0,0,0,0,0,0
./data/output_files/out/UN_125_em_551.lg, Incorrect,7,0,7,7,0,0.197202659437,5,20,3,7,0,5,0,0,3,3,0,3,3,0,0,0,0,1,1,0,0,0
./data/output_files/out/UN_125_em_552.lg, Incorrect,14,4,10,10,0,0.244444444444,10,90,8,10,0,6,0,0,9,9,0,9,5,4,0,0,0,1,0,0,0,0
./data/output_files/out/UN_125_em_553.lg, Incorrect,20,3,17,13,4,0.315144001453,10,90,6,14,2,7,2,1,7,8,0,6,6,1,0,0,0,0,0,0,0,0
./data/output_files/out/UN_125_em_554.lg, Incorrect,24,4,20,8,12,0.520174784851,8,56,3,14,6,0,0,0,4,5,0,3,3,1,0,0,0,0,0,0,0,0
./data/output_files/out/UN_125_em_555.lg, Incorrect,12,1,11,11,0,0.149867649797,10,90,9,11,0,0,0,0,9,8,0,8,8,1,0,0,0,0,0,0,0,0
./data/output_files/out/UN_125_em_556.lg, Incorrect,35,5,30,26,4,0.191714914677,22,462,16,28,2,0,0,0,17,18,0,15,14,3,0,0,0,0,0,0,0,0
./data/output_files/out/UN_125_em_557.lg, Incorrect,3,0,3,3,0,0.235702260396,3,6,3,3,0,3,0,0,3,3,0,3,3,0,0,0,0,1,1,0,0,0
./data/output_files/out/UN_125_em_558.lg, Incorrect,4,2,2,2,0,0.414672311952,3,6,2,2,0,1,0,0,3,3,0,3,1,2,0,0,0,1,0,0,0,0
./data/output_files/out/UN_125_em_559.lg, Incorrect,18,4,14,8,6,0.508914437876,7,42,4,11,3,0,0,0,5,5,0,4,3,2,0,0,0,0,0,0,0,0
./data/output_files/out/UN_125_em_560.lg, Incorrect,14,1,13,13,0,0.17867646797,9,72,4,13,0,8,0,0,5,5,0,5,4,1,0,0,0,1,0,0,0,0
./data/output_files/out/UN_125_em_561.lg, Incorrect,16,3,13,11,2,0.250447690232,11,110,8,12,1,0,0,0,9,9,0,7,7,2,0,0,0,0,0,0,0,0
./data/output_files/out/UN_125_em_562.lg, Incorrect,16,0,16,16,0,0.116051770637,12,132,8,16,0,12,0,0,9,9,0,9,9,0,0,0,0,1,1,0,0,0
./data/output_files/out/UN_125_em_563.lg, Incorrect,49,8,41,37,4,0.162053863716,34,1122,28,39,2,0,0,0,29,26,0,24,22,7,0,0,0,0,0,0,0,0
./data/output_files/out/UN_125_em_564.lg, Incorrect,17,3,14,8,6,0.461295390257,7,42,4,11,3,0,0,0,5,5,0,4,4,1,0,0,0,0,0,0,0,0
./data/output_files/out/UN_125_em_565.lg, Incorrect,33,3,30,30,0,0.159926270736,18,306,11,30,0,0,0,0,12,10,0,10,9,3,0,0,0,0,0,0,0,0
./data/output_files/out/UN_125_em_566.lg, Incorrect,23,2,21,21,0,0.188509561425,12,132,5,20,0,10,2,1,6,6,0,6,5,1,0,0,0,1,0,0,0,0
./data/output_files/out/UN_125_em_567.lg, Incorrect,32,6,26,20,6,0.218014607471,21,420,17,23,3,0,0,0,18,16,0,13,12,6,0,0,0,0,0,0,0,0
./data/output_files/out/UN_126_em_568.lg, Incorrect,49,8,41,25,16,0.417072369305,15,210,8,32,8,7,2,1,9,8,0,4,3,6,0,0,0,0,0,0,0,0
./data/output_files/out/UN_126_em_569.lg, Incorrect,87,24,63,37,26,0.400556598275,31,930,22,46,13,0,8,4,23,12,0,6,3,20,0,0,0,0,0,0,0,0
./data/output_files/out/UN_126_em_570.lg, Incorrect,15,5,10,10,0,0.349192375788,8,56,6,9,0,0,2,1,7,5,0,5,3,4,0,0,0,0,0,0,0,0
./data/output_files/out/UN_126_em_571.lg, Incorrect,45,11,34,24,10,0.355081842693,19,342,12,29,5,0,0,0,13,12,0,8,6,7,0,0,0,0,0,0,0,0
./data/output_files/out/UN_126_em_572.lg, Incorrect,17,5,12,6,6,0.417492993538,9,72,8,9,3,0,0,0,9,5,0,4,4,5,0,0,0,0,0,0,0,0
./data/output_files/out/UN_126_em_573.lg, Incorrect,28,7,21,19,2,0.208648895673,21,420,20,20,1,0,0,0,21,17,0,16,14,7,0,0,0,0,0,0,0,0
./data/output_files/out/UN_126_em_574.lg, Incorrect,12,4,8,6,2,0.408694080712,7,42,5,7,1,0,0,0,6,5,0,4,3,3,0,0,0,0,0,0,0,0
./data/output_files/out/UN_126_em_575.lg, Incorrect,12,4,8,8,0,0.292654824336,8,56,6,8,0,0,0,0,7,6,0,6,3,4,0,0,0,0,0,0,0,0
./data/output_files/out/UN_126_em_576.lg, Incorrect,16,4,12,10,2,0.304739856723,10,90,8,11,1,0,0,0,9,9,0,7,6,3,0,0,0,0,0,0,0,0
./data/output_files/out/UN_126_em_577.lg, Incorrect,36,8,28,22,6,0.411720007797,13,156,8,22,3,0,6,3,9,7,0,7,5,4,0,0,0,0,0,0,0,0
./data/output_files/out/UN_126_em_578.lg, Incorrect,58,18,40,28,12,0.33295571788,28,756,22,34,6,0,0,0,23,16,0,12,8,15,0,0,0,0,0,0,0,0
./data/output_files/out/UN_126_em_579.lg, Incorrect,31,9,22,14,8,0.511691786222,11,110,5,18,4,0,0,0,6,5,0,2,1,5,0,0,0,0,0,0,0,0
./data/output_files/out/UN_126_em_580.lg, Incorrect,22,7,15,9,6,0.507629458987,9,72,6,12,3,0,0,0,7,4,0,2,1,6,0,0,0,0,0,0,0,0
./data/output_files/out/UN_126_em_581.lg, Incorrect,38,12,26,18,8,0.449015263288,15,210,10,22,4,0,0,0,11,9,0,6,3,8,0,0,0,0,0,0,0,0
./data/output_files/out/UN_126_em_582.lg, Incorrect,15,5,10,8,2,0.412186454623,8,56,6,9,1,0,0,0,7,6,0,4,3,4,0,0,0,0,0,0,0,0
./data/output_files/out/UN_126_em_583.lg, Incorrect,39,11,28,22,6,0.332510765296,19,342,14,25,3,8,0,0,15,18,0,12,7,8,0,0,0,0,0,0,0,0
./data/output_files/out/UN_126_em_584.lg, Incorrect,9,3,6,4,2,0.401804161749,6,30,3,5,1,0,0,0,5,3,0,2,2,3,0,0,0,0,0,0,0,0
./data/output_files/out/UN_127_em_585.lg, Incorrect,56,15,41,27,14,0.403100123547,21,420,14,32,7,0,4,2,15,13,0,10,4,11,0,0,0,0,0,0,0,0
./data/output_files/out/UN_127_em_586.lg, Incorrect,100,16,84,70,14,0.262025604824,37,1332,20,77,7,0,0,0,21,22,0,14,12,9,0,0,0,0,0,0,0,0
./data/output_files/out/UN_127_em_587.lg, Incorrect,26,5,21,17,4,0.262524737073,15,210,10,19,2,0,0,0,11,12,0,8,7,4,0,0,0,0,0,0,0,0
./data/output_files/out/UN_127_em_588.lg, Incorrect,46,16,30,26,4,0.328306173934,24,552,19,28,2,0,0,0,20,17,0,15,6,14,0,0,0,0,0,0,0,0
./data/output_files/out/UN_127_em_589.lg, Incorrect,45,7,38,24,14,0.286056913335,20,380,11,31,7,0,0,0,12,14,0,9,9,3,0,0,0,0,0,0,0,0
./data/output_files/out/UN_127_em_590.lg, Incorrect,6,3,3,3,0,0.416666666667,4,12,3,3,0,0,0,0,4,1,0,1,1,3,0,0,0,0,0,0,0,0
./data/output_files/out/UN_127_em_591.lg, Incorrect,19,4,15,13,2,0.355848858566,9,72,5,14,1,0,0,0,6,6,0,5,3,3,0,0,0,0,0,0,0,0
./data/output_files/out/UN_127_em_592.lg, Incorrect,18,2,16,14,2,0.324501573443,8,56,3,15,1,6,0,0,4,5,0,3,3,1,0,0,0,0,0,0,0,0
./data/output_files/out/UN_127_em_593.lg, Incorrect,49,12,37,25,12,0.455415810243,16,240,9,29,6,0,4,2,10,10,0,7,3,7,0,0,0,0,0,0,0,0
./data/output_files/out/UN_127_em_594.lg, Incorrect,16,5,11,11,0,0.235113933754,12,132,11,11,0,0,0,0,12,8,0,8,7,5,0,0,0,0,0,0,0,0
./data/output_files/out/UN_127_em_595.lg, Incorrect,42,8,34,30,4,0.222213593487,24,552,18,32,2,0,0,0,19,17,0,14,12,7,0,0,0,0,0,0,0,0
./data/output_files/out/UN_127_em_596.lg, Incorrect,49,9,40,36,4,0.194076285777,30,870,22,38,2,0,0,0,23,19,0,18,16,7,0,0,0,0,0,0,0,0
./data/output_files/out/UN_127_em_597.lg, Incorrect,10,4,6,6,0,0.569035593729,4,12,2,5,0,0,2,1,3,3,0,3,0,3,0,0,0,1,0,0,0,0
./data/output_files/out/UN_127_em_598.lg, Incorrect,66,4,62,58,4,0.150937910463,31,930,17,60,2,0,0,0,18,17,0,15,15,3,0,0,0,0,0,0,0,0
./data/output_files/out/UN_127_em_599.lg, Incorrect,60,9,51,39,12,0.315356101912,21,420,12,43,6,0,4,2,13,14,0,10,9,4,0,0,0,0,0,0,0,0
./data/output_files/out/UN_127_em_600.lg, Incorrect,26,2,24,22,2,0.203607382044,14,182,7,23,1,0,0,0,8,8,0,7,7,1,0,0,0,0,0,0,0,0
./data/output_files/out/UN_127_em_601.lg, Incorrect,57,8,49,31,18,0.249554985251,26,650,17,39,9,0,2,1,18,17,0,14,14,4,0,0,0,0,0,0,0,0
./data/output_files/out/UN_128_em_1000.lg, Incorrect,46,11,35,29,6,0.363112963437,18,306,11,32,3,0,0,0,12,11,0,8,4,8,0,0,0,0,0,0,0,0
./data/output_files/out/UN_128_em_1001.lg, Incorrect,25,6,19,17,2,0.307919128393,13,156,9,18,1,0,0,0,10,8,0,7,3,7,0,0,0,0,0,0,0,0
./data/output_files/out/UN_128_em_1002.lg, Incorrect,46,7,39,33,6,0.332908923474,16,240,8,36,3,0,0,0,9,8,0,5,4,5,0,0,0,0,0,0,0,0
./data/output_files/out/UN_128_em_1003.lg, Incorrect,17,3,14,14,0,0.191889824546,12,132,8,14,0,0,0,0,9,8,0,8,6,3,0,0,0,0,0,0,0,0
./data/output_files/out/UN_128_em_1004.lg, Incorrect,21,4,17,15,2,0.232055897379,14,182,11,16,1,0,0,0,12,12,0,11,9,3,0,0,0,0,0,0,0,0
./data/output_files/out/UN_128_em_1005.lg, Incorrect,48,8,40,26,14,0.43919530016,14,182,6,32,7,6,2,1,7,11,0,4,4,3,0,0,0,0,0,0,0,0
./data/output_files/out/UN_128_em_1006.lg, Incorrect,30,7,23,19,4,0.391611514752,12,132,7,20,2,0,2,1,8,6,0,4,3,5,0,0,0,0,0,0,0,0
./data/output_files/out/UN_128_em_1007.lg, Incorrect,24,5,19,15,4,0.257379682987,15,210,11,17,2,0,0,0,12,11,0,9,9,3,0,0,0,0,0,0,0,0
./data/output_files/out/UN_128_em_1008.lg, Incorrect,69,12,57,31,26,0.463251172878,18,306,9,42,13,0,4,2,10,11,0,5,4,6,0,0,0,0,0,0,0,0
./data/output_files/out/UN_128_em_1009.lg, Incorrect,27,6,21,17,4,0.26663447801,16,240,12,19,2,0,0,0,13,10,0,9,8,5,0,0,0,0,0,0,0,0
./data/output_files/out/UN_128_em_1010.lg, Incorrect,7,1,6,6,0,0.249240852502,5,20,2,6,0,4,0,0,3,3,0,3,2,1,0,0,0,1,0,0,0,0
./data/output_files/out/UN_128_em_1011.lg, Incorrect,70,12,58,44,14,0.302337845401,26,650,15,50,7,0,2,1,16,17,0,9,9,7,0,0,0,0,0,0,0,0
./data/output_files/out/UN_128_em_1012.lg, Incorrect,30,6,24,22,2,0.421822992665,10,90,5,20,1,0,6,3,6,5,0,4,3,3,0,0,0,0,0,0,0,0
./data/output_files/out/UN_128_em_1013.lg, Incorrect,8,3,5,5,0,0.366666666667,5,20,3,5,0,0,0,0,4,2,0,2,1,3,0,0,0,0,0,0,0,0
./data/output_files/out/UN_128_em_1014.lg, Incorrect,64,11,53,35,18,0.345362291195,22,462,12,42,9,0,4,2,13,10,0,7,4,9,0,0,0,0,0,0,0,0
./data/output_files/out/UN_128_em_1015.lg, Incorrect,10,0,10,10,0,0.140859042455,8,56,5,10,0,8,0,0,6,6,0,6,6,0,0,0,0,1,1,0,0,0
./data/output_files/out/UN_128_em_1016.lg, Incorrect,25,6,19,19,0,0.183830578027,19,342,17,19,0,0,0,0,18,16,0,16,12,6,0,0,0,0,0,0,0,0
./data/output_files/out/UN_128_em_1017.lg, Incorrect,17,4,13,5,8,0.746227102288,5,20,2,9,4,1,0,0,3,4,0,1,1,2,0,0,0,0,0,0,0,0
./data/output_files/out/UN_128_em_1018.lg, Incorrect,53,11,42,28,14,0.479581939527,15,210,7,34,7,0,2,1,8,7,0,2,2,6,0,0,0,0,0,0,0,0
./data/output_files/out/UN_128_em_1019.lg, Incorrect,20,2,18,18,0,0.152447531291,14,182,8,18,0,0,0,0,9,8,0,8,7,2,0,0,0,0,0,0,0,0
./data/output_files/out/UN_128_em_1020.lg, Incorrect,23,4,19,7,12,0.408205554469,10,90,9,13,6,6,0,0,10,7,0,6,6,4,0,0,0,0,0,0,0,0
./data/output_files/out/UN_128_em_1021.lg, Incorrect,24,4,20,18,2,0.209987409171,16,240,12,19,1,0,0,0,13,12,0,10,10,3,0,0,0,0,0,0,0,0
./data/output_files/out/UN_128_em_1022.lg, Incorrect,34,9,25,23,2,0.235835710396,22,462,18,24,1,0,0,0,19,18,0,16,11,8,0,0,0,0,0,0,0,0
./data/output_files/out/UN_128_em_1023.lg, Incorrect,65,6,59,57,2,0.153902838814,33,1056,23,57,1,0,2,1,24,24,0,22,20,4,0,0,0,0,0,0,0,0
./data/output_files/out/UN_128_em_1024.lg, Incorrect,38,10,28,20,8,0.360192784407,17,272,12,24,4,0,0,0,13,12,0,10,6,7,0,0,0,0,0,0,0,0
./data/output_files/out/UN_129_em_1025.lg, Incorrect,81,19,62,48,14,0.354267450785,29,812,19,54,7,0,2,1,20,19,0,10,7,13,0,0,0,0,0,0,0,0
./data/output_files/out/UN_129_em_1026.lg, Incorrect,32,9,23,17,6,0.424132550447,13,156,8,19,3,0,2,1,9,8,0,4,3,6,0,0,0,0,0,0,0,0
./data/output_files/out/UN_129_em_1027.lg, Incorrect,26,2,24,22,2,0.219768709179,13,156,6,23,1,11,0,0,7,8,0,6,6,1,0,0,0,0,0,0,0,0
./data/output_files/out/UN_129_em_1028.lg, Incorrect,18,5,13,5,8,0.669337233811,6,30,2,9,4,0,0,0,3,4,0,1,1,2,0,0,0,0,0,0,0,0
./data/output_files/out/UN_129_em_1029.lg, Incorrect,37,6,31,29,2,0.199186094522,22,462,16,30,1,0,0,0,17,15,0,14,12,5,0,0,0,0,0,0,0,0
./data/output_files/out/UN_129_em_1030.lg, Incorrect,13,3,10,8,2,0.32885312129,8,56,5,9,1,5,0,0,6,7,0,5,4,2,0,0,0,0,0,0,0,0
./data/output_files/out/UN_129_em_1031.lg, Incorrect,43,9,34,32,2,0.273889715273,20,380,12,31,1,0,4,2,13,12,0,11,7,6,0,0,0,0,0,0,0,0
./data/output_files/out/UN_129_em_1032.lg, Incorrect,20,5,15,9,6,0.489958668287,8,56,5,12,3,0,0,0,6,6,0,3,3,3,0,0,0,0,0,0,0,0
./data/output_files/out/UN_129_em_1033.lg, Incorrect,21,3,18,12,6,0.423091181623,8,56,3,15,3,0,0,0,4,3,0,3,3,1,0,0,0,0,0,0,0,0
./data/output_files/out/UN_129_em_1034.lg, Incorrect,43,6,37,33,4,0.163515303232,29,812,20,35,2,23,0,0,21,21,0,18,16,5,0,0,0,0,0,0,0,0
./data/output_files/out/UN_129_em_1035.lg, Incorrect,28,7,21,7,14,0.761485683459,7,42,2,13,7,0,2,1,3,4,0,0,0,3,0,0,0,0,0,0,0,0
./data/output_files/out/UN_129_em_1036.lg, Incorrect,28,5,23,23,0,0.157369284923,21,420,17,23,0,0,0,0,18,15,0,15,13,5,0,0,0,0,0,0,0,0
./data/output_files/out/UN_129_em_1037.lg, Incorrect,25,6,19,17,2,0.234329179659,17,272,14,18,1,0,0,0,15,13,0,13,10,5,0,0,0,0,0,0,0,0
./data/output_files/out/UN_129_em_1038.lg, Incorrect,25,6,19,15,4,0.299974792744,14,182,9,17,2,0,0,0,10,10,0,7,6,4,0,0,0,0,0,0,0,0
./data/output_files/out/UN_129_em_1039.lg, Incorrect,39,2,37,37,0,0.0975521685966,28,756,20,37,0,0,0,0,21,20,0,20,19,2,0,0,0,0,0,0,0,0
./data/output_files/out/UN_129_em_1040.lg, Incorrect,7,0,7,7,0,0.136082763488,7,42,5,7,0,7,0,0,6,6,0,6,6,0,0,0,0,1,1,0,0,0
./data/output_files/out/UN_129_em_1041.lg, Incorrect,43,7,36,32,4,0.267003836327,19,342,12,33,2,0,2,1,13,13,0,11,9,4,0,0,0,0,0,0,0,0
./data/output_files/out/UN_129_em_1042.lg, Incorrect,16,4,12,8,4,0.673936754914,5,20,2,9,2,0,2,1,3,3,0,2,1,2,0,0,0,0,0,0,0,0
./data/output_files/out/UN_129_em_1043.lg, Incorrect,29,5,24,16,8,0.438180058831,10,90,5,18,4,0,4,2,6,4,0,3,3,3,0,0,0,0,0,0,0,0
./data/output_files/out/UN_129_em_1044.lg, Incorrect,11,4,7,7,0,0.284517796864,8,56,7,7,0,4,0,0,8,8,0,8,4,4,0,0,0,1,0,0,0,0
./data/output_files/out/UN_129_em_1045.lg, Incorrect,4,2,2,2,0,0.414672311952,3,6,2,2,0,0,0,0,3,2,0,2,1,2,0,0,0,0,0,0,0,0
./data/output_files/out/UN_129_em_1046.lg, Incorrect,35,4,31,29,2,0.233561579044,16,240,8,29,1,12,2,1,9,10,0,8,7,2,0,0,0,0,0,0,0,0
./data/output_files/out/UN_129_em_1047.lg, Incorrect,21,5,16,16,0,0.234957230742,13,156,9,15,0,8,2,1,10,10,0,10,6,4,0,0,0,1,0,0,0,0
./data/output_files/out/UN_129_em_1048.lg, Incorrect,43,8,35,17,18,0.695368525889,9,72,3,24,9,0,4,2,4,6,0,3,1,3,0,0,0,0,0,0,0,0
./data/output_files/out/UN_129_em_1049.lg, Incorrect,45,9,36,26,10,0.475292331831,13,156,7,30,5,0,2,1,7,8,0,2,2,5,0,0,0,0,0,0,0,0
./data/output_files/out/UN_130_em_1050.lg, Incorrect,4,1,3,3,0,0.346813371507,3,6,3,3,0,0,0,0,3,2,0,2,2,1,0,0,0,0,0,0,0,0
./data/output_files/out/UN_130_em_1051.lg, Incorrect,18,5,13,11,2,0.382380171674,9,72,6,11,1,4,2,1,7,6,0,5,3,4,0,0,0,0,0,0,0,0
./data/output_files/out/UN_130_em_1052.lg, Incorrect,30,4,26,20,6,0.444681597206,9,72,3,20,3,5,6,3,4,5,0,3,3,1,0,0,0,0,0,0,0,0
./data/output_files/out/UN_130_em_1053.lg, Incorrect,30,2,28,28,0,0.117812328328,21,420,13,28,0,0,0,0,14,13,0,13,12,2,0,0,0,0,0,0,0,0
./data/output_files/out/UN_130_em_1054.lg, Incorrect,5,1,4,4,0,0.215737865167,5,20,3,4,0,4,0,0,4,4,0,4,3,1,0,0,0,1,0,0,0,0
./data/output_files/out/UN_130_em_1055.lg, Incorrect,79,15,64,46,18,0.437221803756,21,420,9,51,9,0,8,4,10,12,0,5,4,6,0,0,0,0,0,0,0,0
./data/output_files/out/UN_130_em_1056.lg, Incorrect,66,12,54,46,8,0.18132782336,41,1640,32,50,4,0,0,0,33,33,0,27,25,8,0,0,0,0,0,0,0,0
./data/output_files/out/UN_130_em_1057.lg, Incorrect,20,3,17,17,0,0.151215107904,16,240,13,17,0,13,0,0,14,14,0,14,11,3,0,0,0,1,0,0,0,0
./data/output_files/out/UN_130_em_1058.lg, Incorrect,34,7,27,19,8,0.364940470201,14,182,10,22,4,7,2,1,11,8,0,5,5,6,0,0,0,0,0,0,0,0
./data/output_files/out/UN_130_em_1059.lg, Incorrect,51,9,42,28,14,0.361458534264,18,306,12,34,7,0,2,1,13,12,0,8,7,6,0,0,0,0,0,0,0,0
./data/output_files/out/UN_130_em_1060.lg, Incorrect,8,0,8,8,0,0.172132593165,6,30,2,8,0,6,0,0,3,3,0,3,3,0,0,0,0,1,1,0,0,0
./data/output_files/out/UN_130_em_1061.lg, Incorrect,26,8,18,16,2,0.307897787504,15,210,12,17,1,0,0,0,13,9,0,7,6,7,0,0,0,0,0,0,0,0
./data/output_files/out/UN_130_em_1062.lg, Incorrect,34,7,27,19,8,0.64910984928,8,56,3,21,4,0,4,2,4,4,0,1,1,3,0,0,0,0,0,0,0,0
./data/output_files/out/UN_130_em_1063.lg, Incorrect,22,4,18,18,0,0.16418066512,17,272,14,18,0,0,0,0,15,13,0,13,11,4,0,0,0,0,0,0,0,0
./data/output_files/out/UN_130_em_1064.lg, Incorrect,21,5,16,14,2,0.272699798547,13,156,10,15,1,0,0,0,11,11,0,9,7,4,0,0,0,0,0,0,0,0
./data/output_files/out/UN_130_em_1065.lg, Incorrect,74,13,61,37,24,0.346284035943,25,600,17,48,12,0,2,1,18,18,0,13,10,8,0,0,0,0,0,0,0,0
./data/output_files/out/UN_130_em_1066.lg, Incorrect,20,5,15,15,0,0.214742494341,14,182,11,15,0,0,0,0,12,8,0,8,7,5,0,0,0,0,0,0,0,0
./data/output_files/out/UN_130_em_1067.lg, Incorrect,23,5,18,18,0,0.195453759584,16,240,12,18,0,0,0,0,13,11,0,11,8,5,0,0,0,0,0,0,0,0
./data/output_files/out/UN_130_em_1068.lg, Incorrect,23,5,18,14,4,0.320006265187,12,132,8,16,2,0,0,0,9,10,0,7,6,3,0,0,0,0,0,0,0,0
./data/output_files/out/UN_130_em_1069.lg, Incorrect,7,2,5,5,0,0.3,5,20,3,5,0,3,0,0,4,4,0,4,2,2,0,0,0,1,0,0,0,0
./data/output_files/out/UN_130_em_1070.lg, Incorrect,21,3,18,16,2,0.196786676393,15,210,8,17,1,0,0,0,9,9,0,7,7,2,0,0,0,0,0,0,0,0
./data/output_files/out/UN_130_em_1071.lg, Incorrect,3,1,2,2,0,0.303561200841,3,6,2,2,0,2,0,0,3,3,0,3,2,1,0,0,0,1,0,0,0,0
./data/output_files/out/UN_130_em_1072.lg, Incorrect,48,11,37,37,0,0.220554166253,26,650,17,35,0,0,4,2,18,14,0,14,9,9,0,0,0,0,0,0,0,0
./data/output_files/out/UN_130_em_1073.lg, Incorrect,2,1,1,1,0,0.402368927062,2,2,1,1,0,1,0,0,2,2,0,2,1,1,0,0,0,1,0,0,0,0
./data/output_files/out/UN_130_em_1074.lg, Incorrect,17,4,13,13,0,0.198789147429,13,156,11,13,0,0,0,0,12,10,0,10,8,4,0,0,0,0,0,0,0,0
./data/output_files/out/UN_131_em_1075.lg, Incorrect,19,4,15,15,0,0.269416096821,10,90,6,14,0,0,2,1,7,6,0,6,4,3,0,0,0,0,0,0,0,0
./data/output_files/out/UN_131_em_1076.lg, Incorrect,44,11,33,27,6,0.293740606124,22,462,16,30,3,0,0,0,17,17,0,12,9,8,0,0,0,0,0,0,0,0
./data/output_files/out/UN_131_em_1077.lg, Incorrect,5,2,3,3,0,0.333333333333,4,12,3,3,0,2,0,0,4,4,0,4,2,2,0,0,0,1,0,0,0,0
./data/output_files/out/UN_131_em_1078.lg, Incorrect,16,3,13,9,4,0.374691099247,8,56,4,11,2,0,0,0,5,4,0,3,2,3,0,0,0,0,0,0,0,0
./data/output_files/out/UN_131_em_1079.lg, Incorrect,11,2,9,7,2,0.322280741946,7,42,4,8,1,0,0,0,5,5,0,4,3,2,0,0,0,0,0,0,0,0
./data/output_files/out/UN_131_em_1080.lg, Incorrect,5,2,3,1,2,0.650374572348,3,6,2,2,1,1,0,0,3,2,0,1,1,2,0,0,0,0,0,0,0,0
./data/output_files/out/UN_131_em_1081.lg, Incorrect,11,1,10,10,0,0.182525709121,8,56,4,10,0,7,0,0,5,5,0,5,4,1,0,0,0,1,0,0,0,0
./data/output_files/out/UN_131_em_1082.lg, Incorrect,3,1,2,2,0,0.303561200841,3,6,2,2,0,0,0,0,3,2,0,2,2,1,0,0,0,0,0,0,0,0
./data/output_files/out/UN_131_em_1083.lg, Incorrect,5,3,2,2,0,0.525783423063,3,6,2,2,0,0,0,0,3,1,0,1,0,3,0,0,0,0,0,0,0,0
./data/output_files/out/UN_131_em_1084.lg, Incorrect,18,6,12,10,2,0.37140652339,10,90,9,11,1,0,0,0,9,7,0,6,4,5,0,0,0,0,0,0,0,0
./data/output_files/out/UN_131_em_1085.lg, Incorrect,3,1,2,2,0,0.303561200841,3,6,2,2,0,0,0,0,3,2,0,2,2,1,0,0,0,0,0,0,0,0
./data/output_files/out/UN_131_em_1086.lg, Incorrect,10,1,9,9,0,0.201922397581,7,42,6,9,0,0,0,0,6,5,0,5,5,1,0,0,0,0,0,0,0,0
./data/output_files/out/UN_131_em_1087.lg, Incorrect,43,8,35,23,12,0.293731050887,20,380,12,29,6,0,0,0,13,12,0,8,8,5,0,0,0,0,0,0,0,0
./data/output_files/out/UN_131_em_1088.lg, Incorrect,16,5,11,9,2,0.41906162224,8,56,6,9,1,3,2,1,7,6,0,5,3,4,0,0,0,0,0,0,0,0
./data/output_files/out/UN_131_em_1089.lg, Incorrect,2,0,2,2,0,0.19245008973,3,6,2,2,0,3,0,0,3,3,0,3,3,0,0,0,0,1,1,0,0,0
./data/output_files/out/UN_131_em_1090.lg, Incorrect,73,15,58,46,12,0.265168343121,33,1056,23,51,6,0,2,1,24,20,0,15,13,11,0,0,0,0,0,0,0,0
./data/output_files/out/UN_131_em_1091.lg, Incorrect,22,2,20,20,0,0.129603377032,17,272,12,20,0,0,0,0,13,12,0,12,11,2,0,0,0,0,0,0,0,0
./data/output_files/out/UN_131_em_1092.lg, Incorrect,21,6,15,13,2,0.320063807404,12,132,9,14,1,0,0,0,10,7,0,6,4,6,0,0,0,0,0,0,0,0
./data/output_files/out/UN_131_em_1093.lg, Incorrect,10,2,8,6,2,0.44956109935,5,20,2,7,1,0,0,0,3,3,0,2,2,1,0,0,0,0,0,0,0,0
./data/output_files/out/UN_131_em_1094.lg, Incorrect,34,7,27,25,2,0.208574625628,22,462,17,25,1,0,2,1,18,17,0,15,13,5,0,0,0,0,0,0,0,0
./data/output_files/out/UN_131_em_1095.lg, Incorrect,22,4,18,14,4,0.319616266321,11,110,8,15,2,7,2,1,9,10,0,8,7,2,0,0,0,0,0,0,0,0
./data/output_files/out/UN_131_em_1096.lg, Incorrect,5,1,4,4,0,0.275783423063,4,12,2,4,0,3,0,0,3,3,0,3,2,1,0,0,0,1,0,0,0,0
./data/output_files/out/UN_131_em_1097.lg, Incorrect,25,4,21,21,0,0.145027057664,20,380,17,21,0,0,0,0,18,17,0,17,14,4,0,0,0,0,0,0,0,0
./data/output_files/out/UN_131_em_1098.lg, Incorrect,68,12,56,42,14,0.391942973987,20,380,11,48,7,0,2,1,12,12,0,7,5,7,0,0,0,0,0,0,0,0
./data/output_files/out/UN_131_em_1099.lg, Incorrect,8,2,6,6,0,0.221226252908,7,42,6,6,0,5,0,0,7,7,0,7,5,2,0,0,0,1,0,0,0,0
./data/output_files/out/UN_132_em_1100.lg, Incorrect,11,3,8,6,2,0.424865556414,6,30,4,7,1,3,0,0,5,6,0,4,3,2,0,0,0,0,0,0,0,0
./data/output_files/out/UN_132_em_1101.lg, Incorrect,201,35,166,114,52,0.347720152428,53,2756,25,135,26,0,10,5,26,33,0,14,10,16,0,0,0,0,0,0,0,0
./data/output_files/out/UN_132_em_1102.lg, Incorrect,23,0,23,23,0,0.0780042055575,21,420,17,23,0,21,0,0,18,18,0,18,18,0,0,0,0,1,1,0,0,0
./data/output_files/out/UN_132_em_1103.lg, Incorrect,23,4,19,15,4,0.356762267471,10,90,4,16,2,0,2,1,5,5,0,3,3,2,0,0,0,0,0,0,0,0
./data/output_files/out/UN_132_em_1104.lg, Incorrect,5,0,5,5,0,0.166666666667,5,20,3,5,0,5,0,0,4,4,0,4,4,0,0,0,0,1,1,0,0,0
./data/output_files/out/UN_132_em_1105.lg, Incorrect,23,3,20,18,2,0.202065569073,15,210,11,19,1,0,0,0,12,12,0,11,10,2,0,0,0,0,0,0,0,0
./data/output_files/out/UN_132_em_1106.lg, Incorrect,29,7,22,14,8,0.720060881643,7,42,2,17,4,0,2,1,3,4,0,0,0,3,0,0,0,0,0,0,0,0
./data/output_files/out/UN_132_em_1107.lg, Incorrect,20,3,17,13,4,0.351649417211,9,72,3,14,2,6,2,1,4,5,0,3,3,1,0,0,0,0,0,0,0,0
./data/output_files/out/UN_132_em_1108.lg, Incorrect,6,3,3,3,0,0.416666666667,4,12,3,3,0,0,0,0,4,3,0,3,1,3,0,0,0,0,0,0,0,0
./data/output_files/out/UN_132_em_1109.lg, Incorrect,31,6,25,25,0,0.176563101317,21,420,14,25,0,0,0,0,15,10,0,10,9,6,0,0,0,0,0,0,0,0
./data/output_files/out/UN_132_em_1110.lg, Incorrect,59,6,53,45,8,0.217559765169,25,600,13,49,4,0,0,0,14,15,0,12,11,3,0,0,0,0,0,0,0,0
./data/output_files/out/UN_132_em_1111.lg, Incorrect,39,7,32,18,14,0.371741861864,15,210,7,25,7,0,0,0,8,9,0,5,5,3,0,0,0,0,0,0,0,0
./data/output_files/out/UN_132_em_1112.lg, Incorrect,26,6,20,18,2,0.406825239764,10,90,5,18,1,0,2,1,6,5,0,3,2,4,0,0,0,0,0,0,0,0
./data/output_files/out/UN_133_em_1114.lg, Incorrect,40,7,33,21,12,0.461614892637,12,132,5,26,6,0,2,1,6,7,0,3,3,3,0,0,0,0,0,0,0,0
./data/output_files/out/UN_133_em_1115.lg, Incorrect,34,7,27,25,2,0.241956235799,19,342,14,25,1,12,2,1,14,13,0,12,8,6,0,0,0,0,0,0,0,0
./data/output_files/out/UN_133_em_1116.lg, Incorrect,13,3,10,6,4,0.584773458896,5,20,2,7,2,2,2,1,3,4,0,2,2,1,0,0,0,0,0,0,0,0
./data/output_files/out/UN_133_em_1117.lg, Incorrect,10,4,6,4,2,0.705118357217,4,12,2,5,1,0,0,0,3,3,0,2,0,3,0,0,0,0,0,0,0,0
./data/output_files/out/UN_133_em_1118.lg, Incorrect,19,2,17,17,0,0.211537831227,10,90,4,16,0,8,2,1,5,5,0,5,4,1,0,0,0,1,0,0,0,0
./data/output_files/out/UN_133_em_1119.lg, Incorrect,24,6,18,14,4,0.528069317142,8,56,3,15,2,0,2,1,4,5,0,2,1,3,0,0,0,0,0,0,0,0
./data/output_files/out/UN_133_em_1120.lg, Incorrect,27,6,21,21,0,0.223601329718,16,240,10,21,0,0,0,0,11,8,0,8,5,6,0,0,0,0,0,0,0,0
./data/output_files/out/UN_133_em_1121.lg, Incorrect,37,6,31,29,2,0.16820831201,26,650,20,30,1,0,0,0,20,17,0,16,15,5,0,0,0,0,0,0,0,0
./data/output_files/out/UN_133_em_1122.lg, Incorrect,34,4,30,28,2,0.205393192037,18,306,10,29,1,0,0,0,11,10,0,9,8,3,0,0,0,0,0,0,0,0
./data/output_files/out/UN_133_em_1123.lg, Incorrect,16,3,13,13,0,0.226686158344,10,90,6,12,0,0,2,1,7,6,0,6,5,2,0,0,0,0,0,0,0,0
./data/output_files/out/UN_133_em_1124.lg, Incorrect,15,3,12,12,0,0.169373109627,13,156,12,12,0,0,0,0,13,12,0,12,10,3,0,0,0,0,0,0,0,0
./data/output_files/out/UN_133_em_1125.lg, Incorrect,16,3,13,11,2,0.276376557844,10,90,6,11,1,7,2,1,7,8,0,6,5,2,0,0,0,0,0,0,0,0
./data/output_files/out/UN_133_em_1126.lg, Incorrect,29,5,24,14,10,0.652721565593,7,42,2,18,5,2,2,1,3,5,0,2,1,2,0,0,0,0,0,0,0,0
./data/output_files/out/UN_133_em_1127.lg, Incorrect,26,7,19,17,2,0.270050936618,16,240,13,18,1,0,0,0,14,10,0,9,8,6,0,0,0,0,0,0,0,0
./data/output_files/out/UN_133_em_1128.lg, Incorrect,7,2,5,3,2,0.405409255339,5,20,4,4,1,0,0,0,5,3,0,2,2,3,0,0,0,0,0,0,0,0
./data/output_files/out/UN_133_em_1129.lg, Incorrect,37,4,33,33,0,0.126388812902,26,650,21,33,0,0,0,0,21,20,0,20,17,4,0,0,0,0,0,0,0,0
./data/output_files/out/UN_133_em_1130.lg, Incorrect,24,2,22,20,2,0.173017376109,16,240,11,21,1,14,0,0,12,13,0,11,11,1,0,0,0,0,0,0,0,0
./data/output_files/out/UN_133_em_1132.lg, Incorrect,48,10,38,32,6,0.370176642121,17,272,9,34,3,0,2,1,10,8,0,6,4,6,0,0,0,0,0,0,0,0
./data/output_files/out/UN_133_em_1133.lg, Incorrect,7,1,6,6,0,0.173607205289,7,42,2,6,0,6,0,0,3,3,0,3,2,1,0,0,0,1,0,0,0,0
./data/output_files/out/UN_133_em_1134.lg, Incorrect,18,1,17,17,0,0.109548441237,16,240,13,17,0,15,0,0,14,14,0,14,13,1,0,0,0,1,0,0,0,0
./data/output_files/out/UN_133_em_1135.lg, Incorrect,32,6,26,12,14,0.643795047956,8,56,2,19,7,0,0,0,3,5,0,1,1,2,0,0,0,0,0,0,0,0
./data/output_files/out/UN_133_em_1136.lg, Incorrect,21,5,16,10,6,0.438545070314,9,72,5,13,3,4,0,0,6,7,0,3,3,3,0,0,0,0,0,0,0,0
./data/output_files/out/UN_133_em_1137.lg, Incorrect,76,19,57,43,14,0.363079671914,28,756,18,48,7,0,4,2,19,15,0,10,7,12,0,0,0,0,0,0,0,0
./data/output_files/out/UN_133_em_1138.lg, Incorrect,29,6,23,19,4,0.227755318726,19,342,15,21,2,0,0,0,16,13,0,11,11,5,0,0,0,0,0,0,0,0
./data/output_files/out/UN_134_em_1139.lg, Incorrect,85,16,69,41,28,0.368606934491,27,702,17,52,14,0,6,3,18,17,0,13,10,8,0,0,0,0,0,0,0,0
./data/output_files/out/UN_134_em_1140.lg, Incorrect,33,5,28,26,2,0.197998660675,20,380,12,26,1,0,2,1,13,13,0,12,9,4,0,0,0,0,0,0,0,0
./data/output_files/out/UN_134_em_1141.lg, Incorrect,21,6,15,13,2,0.273494846042,14,182,11,14,1,0,0,0,12,10,0,9,7,5,0,0,0,0,0,0,0,0
./data/output_files/out/UN_134_em_1142.lg, Incorrect,39,8,31,17,14,0.453578291421,13,156,7,24,7,0,0,0,8,9,0,5,4,4,0,0,0,0,0,0,0,0
./data/output_files/out/UN_134_em_1143.lg, Incorrect,41,6,35,29,6,0.256049222012,19,342,13,31,3,0,2,1,13,10,0,9,9,4,0,0,0,0,0,0,0,0
./data/output_files/out/UN_134_em_1144.lg, Incorrect,36,12,24,20,4,0.425358271253,15,210,10,21,2,0,2,1,11,11,0,9,2,9,0,0,0,0,0,0,0,0
./data/output_files/out/UN_134_em_1145.lg, Incorrect,8,0,8,8,0,0.172132593165,6,30,5,8,0,6,0,0,5,5,0,5,5,0,0,0,0,1,1,0,0,0
./data/output_files/out/UN_134_em_1146.lg, Incorrect,16,6,10,10,0,0.390859042455,8,56,6,9,0,0,2,1,7,6,0,6,2,5,0,0,0,0,0,0,0,0
./data/output_files/out/UN_134_em_1147.lg, Incorrect,14,4,10,4,6,0.684943112897,5,20,2,7,3,1,0,0,3,5,0,2,1,2,0,0,0,0,0,0,0,0
./data/output_files/out/UN_134_em_1148.lg, Incorrect,8,3,5,5,0,0.302749430155,6,30,5,5,0,0,0,0,6,5,0,5,3,3,0,0,0,0,0,0,0,0
./data/output_files/out/UN_134_em_1149.lg, Incorrect,35,6,29,11,18,0.60043814183,9,72,3,19,9,0,2,1,4,4,0,3,2,2,0,0,0,0,0,0,0,0
./data/output_files/out/UN_451_em_600.lg, Incorrect,33,5,28,26,2,0.265357237433,15,210,7,26,1,10,2,1,8,9,0,7,5,3,0,0,0,0,0,0,0,0
./data/output_files/out/UN_451_em_601.lg, Incorrect,49,8,41,29,12,0.240942602864,25,600,17,35,6,0,0,0,18,18,0,14,14,4,0,0,0,0,0,0,0,0
./data/output_files/out/UN_451_em_602.lg, Incorrect,12,2,10,10,0,0.161109842132,11,110,10,10,0,9,0,0,11,11,0,11,9,2,0,0,0,1,0,0,0,0
./data/output_files/out/UN_451_em_603.lg, Incorrect,17,5,12,8,4,0.358655627449,10,90,9,10,2,0,0,0,10,7,0,5,5,5,0,0,0,0,0,0,0,0
./data/output_files/out/UN_451_em_604.lg, Incorrect,36,9,27,21,6,0.330998971686,17,272,12,23,3,0,2,1,13,11,0,9,7,6,0,0,0,0,0,0,0,0
./data/output_files/out/UN_451_em_605.lg, Incorrect,21,1,20,20,0,0.157527601805,12,132,7,20,0,0,0,0,8,7,0,7,7,1,0,0,0,0,0,0,0,0
./data/output_files/out/UN_451_em_606.lg, Incorrect,8,3,5,3,2,0.601248504944,4,12,2,4,1,0,0,0,3,2,0,1,1,2,0,0,0,0,0,0,0,0
./data/output_files/out/UN_451_em_607.lg, Incorrect,21,5,16,14,2,0.25282368916,14,182,11,15,1,0,0,0,12,12,0,10,8,4,0,0,0,0,0,0,0,0
./data/output_files/out/UN_451_em_608.lg, Incorrect,23,6,17,13,4,0.462760528322,9,72,5,15,2,0,0,0,6,6,0,3,2,4,0,0,0,0,0,0,0,0
./data/output_files/out/UN_451_em_609.lg, Incorrect,17,2,15,15,0,0.133531525082,15,210,13,15,0,0,0,0,14,12,0,12,12,2,0,0,0,0,0,0,0,0
./data/output_files/out/UN_451_em_610.lg, Incorrect,2,0,2,2,0,0.19245008973,3,6,1,2,0,3,0,0,2,2,0,2,2,0,0,0,0,1,1,0,0,0
./data/output_files/out/UN_451_em_611.lg, Incorrect,20,6,14,10,4,0.682759474245,6,30,2,11,2,0,2,1,3,4,0,1,0,3,0,0,0,0,0,0,0,0
./data/output_files/out/UN_451_em_612.lg, Incorrect,7,3,4,2,2,0.797948950039,3,6,1,3,1,0,0,0,2,2,0,1,0,2,0,0,0,0,0,0,0,0
./data/output_files/out/UN_451_em_613.lg, Incorrect,29,4,25,23,2,0.167819254883,21,420,14,24,1,0,0,0,15,12,0,11,11,4,0,0,0,0,0,0,0,0
./data/output_files/out/UN_451_em_614.lg, Incorrect,17,4,13,7,6,0.59072028359,6,30,3,10,3,0,0,0,4,5,0,3,2,2,0,0,0,0,0,0,0,0
./data/output_files/out/UN_451_em_615.lg, Incorrect,20,5,15,13,2,0.249685322232,14,182,13,14,1,0,0,0,14,11,0,10,9,5,0,0,0,0,0,0,0,0
./data/output_files/out/UN_451_em_616.lg, Incorrect,37,4,33,27,6,0.179394368001,23,506,16,30,3,0,0,0,17,14,0,13,13,4,0,0,0,0,0,0,0,0
./data/output_files/out/UN_451_em_617.lg, Incorrect,5,2,3,1,2,0.650374572348,3,6,2,2,1,1,0,0,3,2,0,1,1,2,0,0,0,0,0,0,0,0
./data/output_files/out/UN_451_em_618.lg, Incorrect,49,11,38,30,8,0.258601724084,26,650,18,33,4,0,2,1,19,17,0,13,11,8,0,0,0,0,0,0,0,0
./data/output_files/out/UN_451_em_619.lg, Incorrect,52,11,41,27,14,0.284719658507,25,600,16,34,7,0,0,0,17,12,0,10,9,8,0,0,0,0,0,0,0,0
./data/output_files/out/UN_451_em_620.lg, Incorrect,10,2,8,6,2,0.313455985474,7,42,5,7,1,5,0,0,6,7,0,5,5,1,0,0,0,0,0,0,0,0
./data/output_files/out/UN_451_em_621.lg, Incorrect,7,3,4,2,2,0.797948950039,3,6,1,3,1,0,0,0,2,2,0,1,0,2,0,0,0,0,0,0,0,0
./data/output_files/out/UN_451_em_622.lg, Incorrect,9,3,6,4,2,0.621785023883,4,12,2,5,1,1,0,0,3,4,0,2,1,2,0,0,0,0,0,0,0,0
./data/output_files/out/UN_451_em_623.lg, Incorrect,16,2,14,12,2,0.312994078835,8,56,4,13,1,0,0,0,5,5,0,4,4,1,0,0,0,0,0,0,0,0
./data/output_files/out/UN_451_em_624.lg, Incorrect,61,17,44,30,14,0.340401753106,27,702,18,36,7,0,2,1,19,21,0,12,8,11,0,0,0,0,0,0,0,0
./data/output_files/out/UN_452_em_625.lg, Incorrect,30,9,21,17,4,0.2625596694,20,380,19,19,2,0,0,0,20,15,0,13,9,11,0,0,0,0,0,0,0,0
./data/output_files/out/UN_452_em_626.lg, Incorrect,8,0,8,8,0,0.145478593491,7,42,5,8,0,7,0,0,6,6,0,6,6,0,0,0,0,1,1,0,0,0
./data/output_files/out/UN_452_em_627.lg, Incorrect,16,4,12,8,4,0.673936754914,5,20,3,10,2,0,0,0,3,3,0,1,0,3,0,0,0,0,0,0,0,0
./data/output_files/out/UN_452_em_628.lg, Incorrect,15,4,11,5,6,0.487053120052,7,42,5,8,3,3,0,0,6,4,0,3,2,4,0,0,0,0,0,0,0,0
./data/output_files/out/UN_452_em_629.lg, Incorrect,19,4,15,11,4,0.339688933714,10,90,7,13,2,0,0,0,8,8,0,6,6,2,0,0,0,0,0,0,0,0
./data/output_files/out/UN_452_em_630.lg, Incorrect,10,2,8,6,2,0.369310000858,6,30,3,7,1,0,0,0,4,3,0,3,3,1,0,0,0,0,0,0,0,0
./data/output_files/out/UN_452_em_631.lg, Incorrect,10,2,8,6,2,0.44956109935,5,20,2,7,1,0,0,0,3,3,0,2,2,1,0,0,0,0,0,0,0,0
./data/output_files/out/UN_452_em_632.lg, Incorrect,18,4,14,14,0,0.219667602324,12,132,8,14,0,0,0,0,9,7,0,7,5,4,0,0,0,0,0,0,0,0
./data/output_files/out/UN_452_em_633.lg, Incorrect,25,5,20,12,8,0.471978388528,9,72,5,16,4,0,0,0,6,5,0,3,1,5,0,0,0,0,0,0,0,0
./data/output_files/out/UN_452_em_634.lg, Incorrect,18,4,14,12,2,0.314492172458,10,90,8,13,1,0,0,0,9,7,0,6,6,3,0,0,0,0,0,0,0,0
./data/output_files/out/UN_452_em_635.lg, Incorrect,32,7,25,19,6,0.378299352704,13,156,8,22,3,0,0,0,9,7,0,6,5,4,0,0,0,0,0,0,0,0
./data/output_files/out/UN_452_em_636.lg, Incorrect,15,4,11,11,0,0.226621376551,11,110,9,11,0,0,0,0,10,8,0,8,6,4,0,0,0,0,0,0,0,0
./data/output_files/out/UN_452_em_637.lg, Incorrect,16,2,14,12,2,0.360427481713,7,42,4,13,1,0,0,0,4,3,0,3,3,1,0,0,0,0,0,0,0,0
./data/output_files/out/UN_452_em_638.lg, Incorrect,14,4,10,8,2,0.370519787956,8,56,6,9,1,0,0,0,7,6,0,5,4,3,0,0,0,0,0,0,0,0
./data/output_files/out/UN_452_em_639.lg, Incorrect,6,2,4,2,2,0.686837838928,3,6,1,3,1,1,0,0,2,3,0,1,1,1,0,0,0,0,0,0,0,0
./data/output_files/out/UN_452_em_640.lg, Incorrect,39,9,30,24,6,0.285543971987,20,380,15,27,3,0,0,0,16,12,0,9,7,9,0,0,0,0,0,0,0,0
./data/output_files/out/UN_452_em_641.lg, Incorrect,22,4,18,14,4,0.444735983809,8,56,5,16,2,0,0,0,5,6,0,3,3,2,0,0,0,0,0,0,0,0
./data/output_files/out/UN_452_em_642.lg, Incorrect,14,2,12,12,0,0.188382790557,10,90,6,12,0,8,0,0,7,7,0,7,5,2,0,0,0,1,0,0,0,0
./data/output_files/out/UN_452_em_643.lg, Incorrect,2,0,2,2,0,0.19245008973,3,6,2,2,0,3,0,0,3,3,0,3,3,0,0,0,0,1,1,0,0,0
./data/output_files/out/UN_452_em_644.lg, Incorrect,2,0,2,2,0,0.19245008973,3,6,2,2,0,3,0,0,3,3,0,3,3,0,0,0,0,1,1,0,0,0
./data/output_files/out/UN_452_em_645.lg, Incorrect,32,7,25,19,6,0.232277070835,21,420,15,22,3,0,0,0,16,14,0,11,10,6,0,0,0,0,0,0,0,0
./data/output_files/out/UN_452_em_646.lg, Incorrect,119,21,98,74,24,0.249688030529,48,2256,30,85,12,0,2,1,31,32,0,20,16,15,0,0,0,0,0,0,0,0
./data/output_files/out/UN_452_em_647.lg, Incorrect,39,7,32,18,14,0.62846766543,9,72,3,25,7,0,0,0,4,7,0,2,1,3,0,0,0,0,0,0,0,0
./data/output_files/out/UN_452_em_648.lg, Incorrect,9,2,7,7,0,0.231320858726,7,42,5,7,0,0,0,0,6,4,0,4,4,2,0,0,0,0,0,0,0,0
./data/output_files/out/UN_452_em_649.lg, Incorrect,26,6,20,6,14,0.615871434889,8,56,6,13,7,2,0,0,7,5,0,3,2,5,0,0,0,0,0,0,0,0
./data/output_files/out/UN_453_em_650.lg, Incorrect,15,3,12,6,6,0.640773075582,5,20,2,9,3,0,0,0,3,3,0,2,2,1,0,0,0,0,0,0,0,0
./data/output_files/out/UN_453_em_651.lg, Incorrect,4,1,3,3,0,0.25,4,12,2,3,0,0,0,0,3,2,0,2,2,1,0,0,0,0,0,0,0,0
./data/output_files/out/UN_453_em_652.lg, Incorrect,36,6,30,24,6,0.295555757867,16,240,10,27,3,0,0,0,10,10,0,7,7,3,0,0,0,0,0,0,0,0
./data/output_files/out/UN_453_em_653.lg, Incorrect,56,11,45,25,20,0.469729278829,16,240,9,33,10,0,4,2,10,12,0,6,5,5,0,0,0,0,0,0,0,0
./data/output_files/out/UN_453_em_654.lg, Incorrect,14,5,9,9,0,0.303036315383,9,72,7,9,0,0,0,0,8,7,0,7,3,5,0,0,0,0,0,0,0,0
./data/output_files/out/UN_453_em_655.lg, Incorrect,30,7,23,15,8,0.41564662342,12,132,7,19,4,0,0,0,8,9,0,6,4,4,0,0,0,0,0,0,0,0
./data/output_files/out/UN_453_em_656.lg, Incorrect,12,2,10,10,0,0.224192375788,8,56,5,10,0,0,0,0,6,5,0,5,4,2,0,0,0,0,0,0,0,0
./data/output_files/out/UN_453_em_657.lg, Incorrect,52,16,36,28,8,0.492159497762,17,272,10,30,4,0,4,2,11,14,0,7,1,10,0,0,0,0,0,0,0,0
./data/output_files/out/UN_453_em_658.lg, Incorrect,39,6,33,23,10,0.280834501188,18,306,11,27,5,12,2,1,12,15,0,10,10,2,0,0,0,0,0,0,0,0
./data/output_files/out/UN_453_em_659.lg, Incorrect,4,1,3,3,0,0.346813371507,3,6,3,3,0,0,0,0,3,2,0,2,2,1,0,0,0,0,0,0,0,0
./data/output_files/out/UN_453_em_660.lg, Incorrect,105,17,88,64,24,0.35026586691,30,870,16,73,12,13,6,3,17,22,0,10,9,8,0,0,0,0,0,0,0,0
./data/output_files/out/UN_453_em_661.lg, Incorrect,20,3,17,15,2,0.29456156406,10,90,4,16,1,0,0,0,5,5,0,3,3,2,0,0,0,0,0,0,0,0
./data/output_files/out/UN_453_em_662.lg, Incorrect,43,6,37,33,4,0.189992466174,25,600,19,35,2,0,0,0,19,17,0,15,14,5,0,0,0,0,0,0,0,0
./data/output_files/out/UN_453_em_663.lg, Incorrect,38,6,32,20,12,0.52047772189,10,90,4,25,6,4,2,1,5,8,0,3,3,2,0,0,0,0,0,0,0,0
./data/output_files/out/UN_453_em_664.lg, Incorrect,30,8,22,20,2,0.605255135678,8,56,3,17,1,0,8,4,4,5,0,3,0,4,0,0,0,0,0,0,0,0
./data/output_files/out/UN_453_em_665.lg, Incorrect,5,2,3,3,0,0.333333333333,4,12,2,3,0,0,0,0,3,2,0,2,1,2,0,0,0,0,0,0,0,0
./data/output_files/out/UN_453_em_666.lg, Incorrect,27,2,25,23,2,0.159262431565,18,306,11,24,1,16,0,0,12,13,0,11,11,1,0,0,0,0,0,0,0,0
./data/output_files/out/UN_453_em_667.lg, Incorrect,7,1,6,2,4,0.398312051002,5,20,2,4,2,4,0,0,3,2,0,1,1,2,0,0,0,0,0,0,0,0
./data/output_files/out/UN_453_em_668.lg, Incorrect,37,3,34,32,2,0.173889715273,20,380,11,33,1,0,0,0,12,11,0,10,10,2,0,0,0,0,0,0,0,0
./data/output_files/out/UN_453_em_669.lg, Incorrect,11,2,9,9,0,0.191925204272,9,72,7,9,0,7,0,0,8,8,0,8,6,2,0,0,0,1,0,0,0,0
./data/output_files/out/UN_453_em_670.lg, Incorrect,4,1,3,1,2,0.539263461237,3,6,2,2,1,2,0,0,3,2,0,1,1,2,0,0,0,0,0,0,0,0
./data/output_files/out/UN_453_em_671.lg, Incorrect,16,6,10,8,2,0.360801510611,10,90,9,9,1,0,0,0,10,8,0,7,4,6,0,0,0,0,0,0,0,0
./data/output_files/out/UN_453_em_672.lg, Incorrect,12,2,10,8,2,0.389627497423,6,30,2,9,1,0,0,0,3,3,0,2,2,1,0,0,0,0,0,0,0,0
./data/output_files/out/UN_453_em_673.lg, Incorrect,27,5,22,16,6,0.417537374073,10,90,6,19,3,0,0,0,7,8,0,6,4,3,0,0,0,0,0,0,0,0
./data/output_files/out/UN_453_em_674.lg, Incorrect,33,7,26,20,6,0.555792708317,9,72,3,21,3,2,4,2,4,6,0,2,1,3,0,0,0,0,0,0,0,0
./data/output_files/out/UN_454_em_675.lg, Incorrect,33,7,26,22,4,0.226576672131,21,420,16,24,2,0,0,0,17,15,0,13,11,6,0,0,0,0,0,0,0,0
./data/output_files/out/UN_454_em_676.lg, Incorrect,38,10,28,20,8,0.339913681079,18,306,12,24,4,0,0,0,13,13,0,7,5,8,0,0,0,0,0,0,0,0
./data/output_files/out/UN_454_em_677.lg, Incorrect,25,6,19,19,0,0.270176560588,13,156,8,18,0,0,2,1,9,8,0,8,4,5,0,0,0,0,0,0,0,0
./data/output_files/out/UN_454_em_678.lg, Incorrect,40,1,39,35,4,0.116074811014,27,702,17,37,2,26,0,0,18,17,0,16,16,2,0,0,0,0,0,0,0,0
./data/output_files/out/UN_454_em_679.lg, Incorrect,72,11,61,49,12,0.182230981419,41,1640,32,55,6,0,0,0,33,29,0,26,24,9,0,0,0,0,0,0,0,0
./data/output_files/out/UN_454_em_680.lg, Incorrect,14,4,10,10,0,0.221715902738,11,110,8,10,0,0,0,0,9,8,0,8,5,4,0,0,0,0,0,0,0,0
./data/output_files/out/UN_454_em_681.lg, Incorrect,16,6,10,6,4,0.479946123092,8,56,5,8,2,0,0,0,6,4,0,2,1,5,0,0,0,0,0,0,0,0
./data/output_files/out/UN_454_em_682.lg, Incorrect,36,5,31,29,2,0.213566673949,19,342,12,30,1,0,0,0,13,12,0,10,9,4,0,0,0,0,0,0,0,0
./data/output_files/out/UN_454_em_683.lg, Incorrect,20,6,14,10,4,0.682759474245,6,30,2,11,2,0,2,1,3,4,0,1,0,3,0,0,0,0,0,0,0,0
./data/output_files/out/UN_454_em_684.lg, Incorrect,24,5,19,19,0,0.265353373995,12,132,6,17,0,0,4,2,7,6,0,6,4,3,0,0,0,0,0,0,0,0
./data/output_files/out/UN_454_em_685.lg, Incorrect,34,8,26,18,8,0.337238160046,16,240,10,22,4,0,0,0,11,11,0,6,6,5,0,0,0,0,0,0,0,0
./data/output_files/out/UN_454_em_686.lg, Incorrect,63,17,46,26,20,0.365094208804,26,650,21,35,10,0,2,1,22,15,0,11,7,15,0,0,0,0,0,0,0,0
./data/output_files/out/UN_454_em_687.lg, Incorrect,42,6,36,30,6,0.232669056177,21,420,15,32,3,0,2,1,15,14,0,11,10,5,0,0,0,0,0,0,0,0
./data/output_files/out/UN_454_em_688.lg, Incorrect,16,4,12,8,4,0.55475685679,6,30,2,10,2,0,0,0,3,2,0,1,1,2,0,0,0,0,0,0,0,0
./data/output_files/out/UN_454_em_689.lg, Incorrect,20,2,18,16,2,0.240392690596,11,110,5,17,1,0,0,0,6,6,0,5,5,1,0,0,0,0,0,0,0,0
./data/output_files/out/UN_454_em_690.lg, Incorrect,41,9,32,30,2,0.200071196558,27,702,21,31,1,0,0,0,22,18,0,17,14,8,0,0,0,0,0,0,0,0
./data/output_files/out/UN_454_em_691.lg, Incorrect,20,2,18,16,2,0.219677543528,12,132,8,17,1,0,0,0,9,7,0,6,6,3,0,0,0,0,0,0,0,0
./data/output_files/out/UN_454_em_692.lg, Incorrect,56,16,40,24,16,0.327422607275,27,702,23,31,8,0,2,1,24,16,0,12,10,14,0,0,0,0,0,0,0,0
./data/output_files/out/UN_454_em_693.lg, Incorrect,3,1,2,2,0,0.303561200841,3,6,2,2,0,2,0,0,3,3,0,3,2,1,0,0,0,1,0,0,0,0
./data/output_files/out/UN_454_em_694.lg, Incorrect,36,7,29,17,12,0.451187703731,12,132,6,22,6,0,2,1,7,8,0,4,4,3,0,0,0,0,0,0,0,0
./data/output_files/out/UN_454_em_695.lg, Incorrect,3,1,2,2,0,0.303561200841,3,6,2,2,0,0,0,0,3,2,0,2,2,1,0,0,0,0,0,0,0,0
./data/output_files/out/UN_454_em_696.lg, Incorrect,34,6,28,24,4,0.281888156802,16,240,9,26,2,0,0,0,10,8,0,6,6,4,0,0,0,0,0,0,0,0
./data/output_files/out/UN_454_em_697.lg, Incorrect,25,1,24,24,0,0.0911252327913,22,462,18,24,0,0,0,0,19,18,0,18,18,1,0,0,0,0,0,0,0,0
./data/output_files/out/UN_454_em_698.lg, Incorrect,17,3,14,8,6,0.461295390257,7,42,4,11,3,0,0,0,5,6,0,4,4,1,0,0,0,0,0,0,0,0
./data/output_files/out/UN_454_em_699.lg, Incorrect,52,10,42,24,18,0.542596133712,13,156,5,32,9,0,2,1,6,10,0,3,2,4,0,0,0,0,0,0,0,0
./data/output_files/out/UN_455_em_700.lg, Incorrect,28,2,26,26,0,0.126995518395,19,342,14,26,0,0,0,0,14,13,0,13,12,2,0,0,0,0,0,0,0,0
./data/output_files/out/UN_455_em_701.lg, Incorrect,13,3,10,10,0,0.235337109861,9,72,6,10,0,6,0,0,7,7,0,7,4,3,0,0,0,1,0,0,0,0
./data/output_files/out/UN_455_em_702.lg, Incorrect,4,2,2,2,0,0.414672311952,3,6,2,2,0,1,0,0,3,3,0,3,1,2,0,0,0,1,0,0,0,0
./data/output_files/out/UN_455_em_703.lg, Incorrect,14,2,12,10,2,0.30063076213,8,56,5,11,1,6,0,0,6,7,0,5,5,1,0,0,0,0,0,0,0,0
./data/output_files/out/UN_455_em_704.lg, Incorrect,21,5,16,14,2,0.323590154245,11,110,6,14,1,0,2,1,7,7,0,6,4,3,0,0,0,0,0,0,0,0
./data/output_files/out/UN_455_em_705.lg, Incorrect,26,4,22,20,2,0.214684042776,16,240,12,21,1,0,0,0,13,12,0,10,10,3,0,0,0,0,0,0,0,0
./data/output_files/out/UN_455_em_706.lg, Incorrect,16,6,10,8,2,0.45385312129,8,56,6,9,1,0,0,0,7,5,0,4,2,5,0,0,0,0,0,0,0,0
./data/output_files/out/UN_455_em_707.lg, Incorrect,15,4,11,7,4,0.403487957375,8,56,5,9,2,0,0,0,6,4,0,3,3,3,0,0,0,0,0,0,0,0
./data/output_files/out/UN_455_em_708.lg, Incorrect,36,7,29,29,0,0.166616144213,25,600,22,29,0,0,0,0,22,18,0,18,15,7,0,0,0,0,0,0,0,0
./data/output_files/out/UN_455_em_709.lg, Incorrect,22,4,18,16,2,0.300998751202,11,110,7,17,1,0,0,0,8,8,0,6,5,3,0,0,0,0,0,0,0,0
./data/output_files/out/UN_455_em_710.lg, Incorrect,24,3,21,19,2,0.204605924437,15,210,12,20,1,12,0,0,12,13,0,11,10,2,0,0,0,0,0,0,0,0
./data/output_files/out/UN_455_em_711.lg, Incorrect,15,7,8,6,2,0.551551223569,7,42,5,7,1,0,0,0,6,5,0,3,0,6,0,0,0,0,0,0,0,0
./data/output_files/out/UN_455_em_712.lg, Incorrect,59,15,44,28,16,0.359193719146,24,552,17,36,8,0,0,0,18,13,0,11,8,10,0,0,0,0,0,0,0,0
./data/output_files/out/UN_455_em_713.lg, Incorrect,21,7,14,14,0,0.259116699371,14,182,12,14,0,0,0,0,13,12,0,12,6,7,0,0,0,0,0,0,0,0
./data/output_files/out/UN_455_em_714.lg, Incorrect,7,3,4,2,2,0.578532853218,4,12,3,3,1,1,0,0,4,3,0,2,1,3,0,0,0,0,0,0,0,0
./data/output_files/out/UN_455_em_715.lg, Incorrect,46,11,35,33,2,0.228023833676,27,702,19,34,1,0,0,0,20,18,0,16,10,10,0,0,0,0,0,0,0,0
./data/output_files/out/UN_455_em_716.lg, Incorrect,30,8,22,10,12,0.616635992582,9,72,5,16,6,0,0,0,6,4,0,1,1,5,0,0,0,0,0,0,0,0
./data/output_files/out/UN_455_em_717.lg, Incorrect,11,3,8,8,0,0.222222222222,9,72,8,8,0,0,0,0,9,6,0,6,6,3,0,0,0,0,0,0,0,0
./data/output_files/out/UN_455_em_718.lg, Incorrect,16,6,10,10,0,0.282321963344,11,110,10,10,0,0,0,0,11,8,0,8,5,6,0,0,0,0,0,0,0,0
./data/output_files/out/UN_455_em_719.lg, Incorrect,34,10,24,18,6,0.366447216342,16,240,12,21,3,0,0,0,13,12,0,8,6,7,0,0,0,0,0,0,0,0
./data/output_files/out/UN_455_em_720.lg, Incorrect,63,11,52,48,4,0.153921157753,44,1892,38,50,2,0,0,0,39,36,0,35,30,9,0,0,0,0,0,0,0,0
./data/output_files/out/UN_455_em_721.lg, Incorrect,16,4,12,10,2,0.304739856723,10,90,8,11,1,0,0,0,9,8,0,7,6,3,0,0,0,0,0,0,0,0
./data/output_files/out/UN_455_em_722.lg, Incorrect,20,3,17,13,4,0.457795712925,7,42,3,14,2,4,2,1,4,5,0,3,3,1,0,0,0,0,0,0,0,0
./data/output_files/out/UN_455_em_723.lg, Incorrect,12,4,8,4,4,0.797948950039,4,12,1,6,2,0,0,0,2,2,0,0,0,2,0,0,0,0,0,0,0,0
./data/output_files/out/UN_455_em_724.lg, Incorrect,27,7,20,20,0,0.324194268471,12,132,8,17,0,5,6,3,9,9,0,9,5,4,0,0,0,1,0,0,0,0
./data/output_files/out/UN_456_em_725.lg, Incorrect,20,0,20,20,0,0.129749824027,12,132,5,20,0,12,0,0,6,6,0,6,6,0,0,0,0,1,1,0,0,0
./data/output_files/out/UN_456_em_726.lg, Incorrect,75,22,53,41,12,0.332432306679,33,1056,24,46,6,0,2,1,25,20,0,17,9,16,0,0,0,0,0,0,0,0
./data/output_files/out/UN_456_em_727.lg, Incorrect,26,4,22,14,8,0.397518543158,10,90,5,18,4,0,0,0,6,8,0,4,4,2,0,0,0,0,0,0,0,0
./data/output_files/out/UN_456_em_728.lg, Incorrect,25,3,22,16,6,0.317830183825,11,110,5,19,3,0,0,0,6,7,0,4,4,2,0,0,0,0,0,0,0,0
./data/output_files/out/UN_456_em_729.lg, Incorrect,8,3,5,5,0,0.302749430155,6,30,5,5,0,0,0,0,6,5,0,5,3,3,0,0,0,0,0,0,0,0
./data/output_files/out/UN_456_em_730.lg, Incorrect,26,7,19,15,4,0.37893481487,12,132,9,17,2,0,0,0,10,8,0,6,5,5,0,0,0,0,0,0,0,0
./data/output_files/out/UN_456_em_731.lg, Incorrect,12,2,10,10,0,0.177777777778,10,90,8,10,0,8,0,0,9,9,0,9,7,2,0,0,0,1,0,0,0,0
./data/output_files/out/UN_456_em_732.lg, Incorrect,22,3,19,19,0,0.156288572312,16,240,11,19,0,0,0,0,12,11,0,11,9,3,0,0,0,0,0,0,0,0
./data/output_files/out/UN_456_em_733.lg, Incorrect,16,3,13,7,6,0.535164728035,6,30,3,10,3,3,0,0,4,6,0,3,3,1,0,0,0,0,0,0,0,0
./data/output_files/out/UN_456_em_734.lg, Incorrect,12,4,8,8,0,0.259259259259,9,72,8,8,0,0,0,0,9,8,0,8,5,4,0,0,0,0,0,0,0,0
./data/output_files/out/UN_456_em_735.lg, Incorrect,32,7,25,15,10,0.471535425188,11,110,5,19,5,4,2,1,6,9,0,4,3,3,0,0,0,0,0,0,0,0
./data/output_files/out/UN_456_em_736.lg, Incorrect,48,9,39,29,10,0.36660387838,17,272,12,34,5,0,0,0,12,13,0,8,4,8,0,0,0,0,0,0,0,0
./data/output_files/out/UN_456_em_737.lg, Incorrect,33,12,21,15,6,0.3774213165,17,272,15,17,3,0,2,1,16,11,0,8,5,11,0,0,0,0,0,0,0,0
./data/output_files/out/UN_456_em_738.lg, Incorrect,4,0,4,4,0,0.19245008973,4,12,2,4,0,4,0,0,3,3,0,3,3,0,0,0,0,1,1,0,0,0
./data/output_files/out/UN_456_em_739.lg, Incorrect,29,6,23,17,6,0.280894492231,16,240,12,20,3,0,0,0,13,13,0,8,8,5,0,0,0,0,0,0,0,0
./data/output_files/out/UN_456_em_740.lg, Incorrect,31,5,26,22,4,0.256913246392,16,240,11,24,2,0,0,0,12,11,0,9,9,3,0,0,0,0,0,0,0,0
./data/output_files/out/UN_456_em_741.lg, Incorrect,7,4,3,3,0,0.5,4,12,3,3,0,0,0,0,4,3,0,3,0,4,0,0,0,0,0,0,0,0
./data/output_files/out/UN_456_em_742.lg, Incorrect,21,6,15,13,2,0.42992293264,9,72,5,13,1,0,2,1,6,5,0,3,2,4,0,0,0,0,0,0,0,0
./data/output_files/out/UN_456_em_743.lg, Incorrect,30,5,25,21,4,0.272126408291,15,210,11,23,2,0,0,0,12,13,0,9,7,5,0,0,0,0,0,0,0,0
./data/output_files/out/UN_456_em_744.lg, Incorrect,101,17,84,60,24,0.281604757223,37,1332,23,72,12,0,0,0,24,22,0,13,12,12,0,0,0,0,0,0,0,0
./data/output_files/out/UN_456_em_745.lg, Incorrect,34,6,28,22,6,0.360437956515,13,156,7,25,3,0,0,0,7,7,0,4,4,3,0,0,0,0,0,0,0,0
./data/output_files/out/UN_456_em_746.lg, Incorrect,41,9,32,18,14,0.366426746078,17,272,10,24,7,0,2,1,11,9,0,4,4,7,0,0,0,0,0,0,0,0
./data/output_files/out/UN_456_em_747.lg, Incorrect,45,12,33,25,8,0.434461370063,16,240,8,27,4,0,4,2,9,9,0,4,2,7,0,0,0,0,0,0,0,0
./data/output_files/out/UN_456_em_748.lg, Incorrect,41,8,33,25,8,0.311509883283,18,306,11,29,4,0,0,0,12,13,0,8,8,4,0,0,0,0,0,0,0,0
./data/output_files/out/UN_456_em_749.lg, Incorrect,55,11,44,34,10,0.249705674744,28,756,22,37,5,0,4,2,23,20,0,17,13,10,0,0,0,0,0,0,0,0
./data/output_files/out/UN_457_em_750.lg, Incorrect,50,13,37,29,8,0.369044794623,20,380,14,32,4,0,2,1,15,13,0,8,6,9,0,0,0,0,0,0,0,0
./data/output_files/out/UN_457_em_751.lg, Incorrect,39,7,32,18,14,0.62846766543,9,72,4,25,7,0,0,0,5,6,0,2,2,3,0,0,0,0,0,0,0,0
./data/output_files/out/UN_457_em_752.lg, Incorrect,18,3,15,11,4,0.524085050952,6,30,2,12,2,3,2,1,3,4,0,2,2,1,0,0,0,0,0,0,0,0
./data/output_files/out/UN_457_em_753.lg, Incorrect,30,7,23,11,12,0.523557800425,10,90,5,16,6,0,2,1,6,8,0,5,3,3,0,0,0,0,0,0,0,0
./data/output_files/out/UN_457_em_754.lg, Incorrect,45,9,36,30,6,0.39435672885,15,210,8,30,3,0,6,3,9,8,0,6,4,5,0,0,0,0,0,0,0,0
./data/output_files/out/UN_457_em_755.lg, Incorrect,36,7,29,19,10,0.53365984851,10,90,4,22,5,0,4,2,5,7,0,2,2,3,0,0,0,0,0,0,0,0
./data/output_files/out/UN_457_em_756.lg, Incorrect,32,7,25,25,0,0.175541646108,23,506,17,25,0,0,0,0,18,14,0,14,11,7,0,0,0,0,0,0,0,0
./data/output_files/out/UN_457_em_757.lg, Incorrect,4,2,2,2,0,0.414672311952,3,6,2,2,0,1,0,0,3,3,0,3,1,2,0,0,0,1,0,0,0,0
./data/output_files/out/UN_457_em_758.lg, Incorrect,5,2,3,3,0,0.457924482618,3,6,3,3,0,0,0,0,3,2,0,2,1,2,0,0,0,0,0,0,0,0
./data/output_files/out/UN_457_em_759.lg, Incorrect,44,10,34,18,16,0.563002621389,12,132,6,26,8,0,0,0,7,8,0,3,2,5,0,0,0,0,0,0,0,0
./data/output_files/out/UN_457_em_760.lg, Incorrect,33,9,24,18,6,0.369030850946,15,210,10,20,3,0,2,1,11,8,0,6,4,7,0,0,0,0,0,0,0,0
./data/output_files/out/UN_457_em_761.lg, Incorrect,51,6,45,37,8,0.330195629242,16,240,5,39,4,0,4,2,6,6,0,4,4,2,0,0,0,0,0,0,0,0
./data/output_files/out/UN_457_em_762.lg, Incorrect,38,8,30,24,6,0.317071982939,17,272,10,27,3,0,0,0,11,10,0,6,6,5,0,0,0,0,0,0,0,0
./data/output_files/out/UN_457_em_763.lg, Incorrect,21,4,17,17,0,0.183729328548,15,210,15,17,0,0,0,0,14,12,0,12,10,4,0,0,0,0,0,0,0,0
./data/output_files/out/UN_457_em_764.lg, Incorrect,25,4,21,17,4,0.240302514851,15,210,11,19,2,0,0,0,12,10,0,7,7,5,0,0,0,0,0,0,0,0
./data/output_files/out/UN_457_em_765.lg, Incorrect,20,4,16,16,0,0.19407133746,14,182,10,16,0,0,0,0,11,8,0,8,7,4,0,0,0,0,0,0,0,0
./data/output_files/out/UN_457_em_766.lg, Incorrect,32,5,27,25,2,0.186882690149,21,420,14,26,1,0,0,0,15,10,0,9,9,6,0,0,0,0,0,0,0,0
./data/output_files/out/UN_457_em_767.lg, Incorrect,2,0,2,2,0,0.19245008973,3,6,2,2,0,3,0,0,3,3,0,3,3,0,0,0,0,1,1,0,0,0
./data/output_files/out/UN_457_em_768.lg, Incorrect,22,1,21,21,0,0.112227664842,17,272,12,21,0,0,0,0,13,12,0,12,12,1,0,0,0,0,0,0,0,0
./data/output_files/out/UN_457_em_769.lg, Incorrect,7,0,7,7,0,0.197202659437,5,20,4,7,0,5,0,0,4,4,0,4,4,0,0,0,0,1,1,0,0,0
./data/output_files/out/UN_457_em_770.lg, Incorrect,15,0,15,15,0,0.0956948752939,14,182,11,15,0,14,0,0,12,12,0,12,12,0,0,0,0,1,1,0,0,0
./data/output_files/out/UN_457_em_771.lg, Incorrect,29,4,25,23,2,0.153019872354,23,506,20,24,1,0,0,0,21,18,0,17,17,4,0,0,0,0,0,0,0,0
./data/output_files/out/UN_457_em_772.lg, Incorrect,12,3,9,7,2,0.284517796864,9,72,8,8,1,0,0,0,9,6,0,5,5,4,0,0,0,0,0,0,0,0
./data/output_files/out/UN_457_em_773.lg, Incorrect,88,23,65,45,20,0.290163466892,41,1640,35,55,10,0,0,0,36,27,0,20,15,21,0,0,0,0,0,0,0,0
./data/output_files/out/UN_457_em_774.lg, Incorrect,29,1,28,28,0,0.134688341844,16,240,9,28,0,0,0,0,10,9,0,9,9,1,0,0,0,0,0,0,0,0
./data/output_files/out/UN_458_em_775.lg, Incorrect,19,2,17,17,0,0.13038177457,16,240,13,17,0,0,0,0,14,13,0,13,12,2,0,0,0,0,0,0,0,0
./data/output_files/out/UN_458_em_776.lg, Incorrect,6,2,4,2,2,0.686837838928,3,6,1,3,1,1,0,0,2,3,0,1,1,1,0,0,0,0,0,0,0,0
./data/output_files/out/UN_458_em_777.lg, Incorrect,32,5,27,25,2,0.16322973137,24,552,20,26,1,0,0,0,21,18,0,17,16,5,0,0,0,0,0,0,0,0
./data/output_files/out/UN_458_em_778.lg, Incorrect,51,9,42,36,6,0.162643350022,37,1332,34,39,3,0,0,0,35,33,0,29,27,8,0,0,0,0,0,0,0,0
./data/output_files/out/UN_458_em_779.lg, Incorrect,34,6,28,20,8,0.370551047079,13,156,7,22,4,7,4,2,8,10,0,6,6,2,0,0,0,0,0,0,0,0
./data/output_files/out/UN_458_em_780.lg, Incorrect,48,7,41,21,20,0.615451026167,10,90,3,30,10,0,2,1,4,5,0,2,2,2,0,0,0,0,0,0,0,0
./data/output_files/out/UN_458_em_781.lg, Incorrect,19,3,16,12,4,0.237051230728,13,156,9,14,2,0,0,0,10,11,0,8,8,2,0,0,0,0,0,0,0,0
./data/output_files/out/UN_458_em_782.lg, Incorrect,34,5,29,19,10,0.423170705725,11,110,6,23,5,6,2,1,7,9,0,6,5,2,0,0,0,0,0,0,0,0
./data/output_files/out/UN_458_em_783.lg, Incorrect,13,2,11,9,2,0.259918956291,9,72,6,10,1,7,0,0,7,8,0,6,6,1,0,0,0,0,0,0,0,0
./data/output_files/out/UN_458_em_784.lg, Incorrect,6,2,4,4,0,0.359116756397,4,12,2,4,0,2,0,0,3,3,0,3,1,2,0,0,0,1,0,0,0,0
./data/output_files/out/UN_458_em_785.lg, Incorrect,7,1,6,6,0,0.173607205289,7,42,6,6,0,6,0,0,7,7,0,7,6,1,0,0,0,1,0,0,0,0
./data/output_files/out/UN_458_em_786.lg, Incorrect,18,3,15,9,6,0.468050068749,7,42,3,12,3,0,0,0,4,3,0,3,3,1,0,0,0,0,0,0,0,0
./data/output_files/out/UN_458_em_787.lg, Incorrect,50,9,41,35,6,0.222484572244,27,702,19,37,3,0,2,1,20,21,0,16,15,5,0,0,0,0,0,0,0,0
./data/output_files/out/UN_458_em_788.lg, Incorrect,12,1,11,9,2,0.222881919254,9,72,8,10,1,8,0,0,8,9,0,7,7,1,0,0,0,0,0,0,0,0
./data/output_files/out/UN_458_em_789.lg, Incorrect,16,4,12,12,0,0.284230911636,9,72,6,11,0,0,2,1,7,6,0,6,4,3,0,0,0,0,0,0,0,0
./data/output_files/out/UN_458_em_790.lg, Incorrect,33,4,29,29,0,0.137770939976,23,506,17,29,0,0,0,0,18,14,0,14,14,4,0,0,0,0,0,0,0,0
./data/output_files/out/UN_458_em_791.lg, Incorrect,18,5,13,5,8,0.669337233811,6,30,2,9,4,0,0,0,3,5,0,1,1,2,0,0,0,0,0,0,0,0
./data/output_files/out/UN_458_em_792.lg, Incorrect,20,5,15,11,4,0.469936803806,8,56,5,12,2,3,2,1,6,7,0,5,3,3,0,0,0,0,0,0,0,0
./data/output_files/out/UN_458_em_793.lg, Incorrect,18,3,15,13,2,0.218027923552,13,156,11,14,1,10,0,0,12,13,0,11,9,3,0,0,0,0,0,0,0,0
./data/output_files/out/UN_458_em_794.lg, Incorrect,30,8,22,22,0,0.213537750531,20,380,16,22,0,0,0,0,17,15,0,15,9,8,0,0,0,0,0,0,0,0
./data/output_files/out/UN_458_em_795.lg, Incorrect,26,2,24,24,0,0.111427939035,21,420,16,24,0,0,0,0,17,16,0,16,15,2,0,0,0,0,0,0,0,0
./data/output_files/out/UN_458_em_796.lg, Incorrect,21,1,20,20,0,0.109995533895,17,272,12,20,0,0,0,0,13,12,0,12,12,1,0,0,0,0,0,0,0,0
./data/output_files/out/UN_458_em_797.lg, Incorrect,28,3,25,25,0,0.128944053698,21,420,15,25,0,0,0,0,16,14,0,14,13,3,0,0,0,0,0,0,0,0
./data/output_files/out/UN_458_em_798.lg, Incorrect,20,6,14,14,0,0.561043350355,6,30,2,11,0,0,6,3,3,3,0,3,0,3,0,0,0,1,0,0,0,0
./data/output_files/out/UN_458_em_799.lg, Incorrect,73,12,61,51,10,0.19260258658,40,1560,31,56,5,0,0,0,32,28,0,25,24,8,0,0,0,0,0,0,0,0
./data/output_files/out/UN_459_em_800.lg, Incorrect,47,12,35,33,2,0.282536805924,23,506,17,31,1,0,6,3,18,15,0,14,10,8,0,0,0,0,0,0,0,0
./data/output_files/out/UN_459_em_801.lg, Incorrect,22,2,20,20,0,0.122255369131,18,306,14,20,0,0,0,0,15,14,0,14,13,2,0,0,0,0,0,0,0,0
./data/output_files/out/UN_459_em_802.lg, Incorrect,22,5,17,13,4,0.425723491285,9,72,5,15,2,0,0,0,6,7,0,4,3,3,0,0,0,0,0,0,0,0
./data/output_files/out/UN_459_em_803.lg, Incorrect,14,4,10,10,0,0.244444444444,10,90,8,10,0,0,0,0,9,7,0,7,5,4,0,0,0,0,0,0,0,0
./data/output_files/out/UN_459_em_804.lg, Incorrect,20,2,18,16,2,0.240392690596,11,110,5,17,1,0,0,0,6,6,0,5,5,1,0,0,0,0,0,0,0,0
./data/output_files/out/UN_459_em_805.lg, Incorrect,25,6,19,19,0,0.218788572312,16,240,14,19,0,0,0,0,14,10,0,10,8,6,0,0,0,0,0,0,0,0
./data/output_files/out/UN_459_em_806.lg, Incorrect,36,8,28,22,6,0.488449129877,11,110,5,22,3,3,6,3,6,6,0,4,2,4,0,0,0,0,0,0,0,0
./data/output_files/out/UN_459_em_807.lg, Incorrect,9,4,5,3,2,0.684581838277,4,12,2,4,1,0,0,0,3,3,0,2,0,3,0,0,0,0,0,0,0,0
./data/output_files/out/UN_459_em_808.lg, Incorrect,4,2,2,2,0,0.414672311952,3,6,2,2,0,0,0,0,3,2,0,2,1,2,0,0,0,0,0,0,0,0
./data/output_files/out/UN_459_em_809.lg, Incorrect,25,4,21,13,8,0.356749252458,11,110,6,17,4,7,0,0,7,10,0,5,5,2,0,0,0,0,0,0,0,0
./data/output_files/out/UN_459_em_810.lg, Incorrect,72,18,54,38,16,0.394433105395,25,600,17,44,8,0,4,2,18,18,0,8,7,11,0,0,0,0,0,0,0,0
./data/output_files/out/UN_459_em_811.lg, Incorrect,62,9,53,41,12,0.277434670183,24,552,14,47,6,0,0,0,15,16,0,12,10,5,0,0,0,0,0,0,0,0
./data/output_files/out/UN_459_em_812.lg, Incorrect,2,0,2,2,0,0.19245008973,3,6,2,2,0,3,0,0,3,3,0,3,3,0,0,0,0,1,1,0,0,0
./data/output_files/out/UN_459_em_813.lg, Incorrect,38,2,36,34,2,0.152338224352,21,420,12,35,1,19,0,0,13,12,0,11,11,2,0,0,0,0,0,0,0,0
./data/output_files/out/UN_459_em_814.lg, Incorrect,107,29,78,54,24,0.357547177446,40,1560,26,64,12,0,4,2,27,25,0,14,6,21,0,0,0,0,0,0,0,0
./data/output_files/out/UN_459_em_815.lg, Incorrect,32,10,22,16,6,0.361959639473,16,240,12,19,3,0,0,0,13,10,0,8,4,9,0,0,0,0,0,0,0,0
./data/output_files/out/UN_459_em_816.lg, Incorrect,3,1,2,2,0,0.303561200841,3,6,2,2,0,0,0,0,3,2,0,2,2,1,0,0,0,0,0,0,0,0
./data/output_files/out/UN_459_em_817.lg, Incorrect,11,0,11,11,0,0.130289326662,9,72,5,11,0,9,0,0,6,6,0,6,6,0,0,0,0,1,1,0,0,0
./data/output_files/out/UN_459_em_818.lg, Incorrect,19,4,15,13,2,0.289250269689,11,110,9,14,1,0,0,0,9,7,0,6,6,3,0,0,0,0,0,0,0,0
./data/output_files/out/UN_459_em_819.lg, Incorrect,97,21,76,56,20,0.243493133799,47,2162,30,64,10,0,4,2,31,33,0,22,18,13,0,0,0,0,0,0,0,0
./data/output_files/out/UN_459_em_820.lg, Incorrect,40,5,35,35,0,0.153379470309,24,552,18,34,0,0,2,1,18,17,0,17,14,4,0,0,0,0,0,0,0,0
./data/output_files/out/UN_459_em_821.lg, Incorrect,53,8,45,39,6,0.222295535256,26,650,16,42,3,0,0,0,17,13,0,13,11,6,0,0,0,0,0,0,0,0
./data/output_files/out/UN_459_em_822.lg, Incorrect,13,3,10,10,0,0.265859042455,8,56,6,9,0,5,2,1,7,7,0,7,5,2,0,0,0,1,0,0,0,0
./data/output_files/out/UN_459_em_823.lg, Incorrect,21,4,17,15,2,0.365674589672,9,72,5,15,1,5,2,1,6,7,0,5,3,3,0,0,0,0,0,0,0,0
./data/output_files/out/UN_459_em_824.lg, Incorrect,20,3,17,13,4,0.315144001453,10,90,8,15,2,7,0,0,8,8,0,6,6,2,0,0,0,0,0,0,0,0
./data/output_files/out/UN_460_em_825.lg, Incorrect,41,8,33,27,6,0.248286060669,22,462,17,30,3,0,0,0,18,16,0,12,11,7,0,0,0,0,0,0,0,0
./data/output_files/out/UN_460_em_826.lg, Incorrect,8,0,8,8,0,0.145478593491,7,42,4,8,0,7,0,0,5,5,0,5,5,0,0,0,0,1,1,0,0,0
./data/output_files/out/UN_460_em_827.lg, Incorrect,19,1,18,16,2,0.259259259259,9,72,3,17,1,0,0,0,4,4,0,3,3,1,0,0,0,0,0,0,0,0
./data/output_files/out/UN_460_em_828.lg, Incorrect,62,13,49,27,22,0.463506269912,18,306,8,38,11,0,0,0,9,11,0,4,3,6,0,0,0,0,0,0,0,0
./data/output_files/out/UN_460_em_829.lg, Incorrect,26,2,24,24,0,0.123389876436,19,342,13,24,0,0,0,0,14,13,0,13,12,2,0,0,0,0,0,0,0,0
./data/output_files/out/UN_460_em_830.lg, Incorrect,25,7,18,6,12,0.634952253133,8,56,5,12,6,1,0,0,6,5,0,1,1,5,0,0,0,0,0,0,0,0
./data/output_files/out/UN_460_em_831.lg, Incorrect,6,2,4,4,0,0.359116756397,4,12,2,4,0,0,0,0,3,1,0,1,1,2,0,0,0,0,0,0,0,0
./data/output_files/out/UN_460_em_832.lg, Incorrect,22,5,17,11,6,0.677773193847,6,30,2,13,3,0,2,1,3,4,0,2,1,2,0,0,0,0,0,0,0,0
./data/output_files/out/UN_460_em_833.lg, Incorrect,37,4,33,25,8,0.185009641799,23,506,18,29,4,0,0,0,19,19,0,15,15,4,0,0,0,0,0,0,0,0
./data/output_files/out/UN_460_em_834.lg, Incorrect,34,7,27,19,8,0.393647364153,13,156,8,23,4,0,0,0,9,8,0,5,5,4,0,0,0,0,0,0,0,0
./data/output_files/out/UN_460_em_835.lg, Incorrect,37,6,31,31,0,0.16232659626,24,552,17,31,0,0,0,0,18,12,0,12,12,6,0,0,0,0,0,0,0,0
./data/output_files/out/UN_460_em_836.lg, Incorrect,5,3,2,2,0,0.525783423063,3,6,2,2,0,0,0,0,3,3,0,3,0,3,0,0,0,1,0,0,0,0
./data/output_files/out/UN_460_em_837.lg, Incorrect,35,7,28,24,4,0.229707410125,21,420,15,26,2,0,0,0,16,13,0,10,10,6,0,0,0,0,0,0,0,0
./data/output_files/out/UN_460_em_838.lg, Incorrect,89,13,76,58,18,0.311884102662,28,756,18,66,9,0,2,1,18,13,0,9,9,9,0,0,0,0,0,0,0,0
./data/output_files/out/UN_460_em_839.lg, Incorrect,25,1,24,24,0,0.126242588672,16,240,10,24,0,0,0,0,11,10,0,10,10,1,0,0,0,0,0,0,0,0
./data/output_files/out/UN_460_em_840.lg, Incorrect,21,6,15,11,4,0.406355600381,10,90,9,13,2,0,0,0,9,7,0,6,4,5,0,0,0,0,0,0,0,0
./data/output_files/out/UN_460_em_841.lg, Incorrect,75,14,61,51,10,0.35011837034,24,552,13,54,5,0,4,2,13,11,0,7,5,8,0,0,0,0,0,0,0,0
./data/output_files/out/UN_460_em_842.lg, Incorrect,45,12,33,25,8,0.329915879529,21,420,12,28,4,0,2,1,13,10,0,7,5,8,0,0,0,0,0,0,0,0
./data/output_files/out/UN_460_em_843.lg, Incorrect,32,7,25,17,8,0.388412443268,13,156,8,21,4,6,0,0,9,10,0,5,3,6,0,0,0,0,0,0,0,0
./data/output_files/out/UN_460_em_844.lg, Incorrect,32,8,24,18,6,0.324780549675,16,240,11,21,3,0,0,0,12,9,0,7,7,5,0,0,0,0,0,0,0,0
./data/output_files/out/UN_460_em_845.lg, Incorrect,11,2,9,7,2,0.379751593529,6,30,4,8,1,0,0,0,4,3,0,3,3,1,0,0,0,0,0,0,0,0
./data/output_files/out/UN_460_em_846.lg, Incorrect,24,6,18,18,0,0.388888888889,9,72,4,15,0,3,6,3,5,5,0,5,2,3,0,0,0,1,0,0,0,0
./data/output_files/out/UN_460_em_847.lg, Incorrect,10,4,6,6,0,0.569035593729,4,12,2,5,0,0,2,1,3,3,0,3,0,3,0,0,0,1,0,0,0,0
./data/output_files/out/UN_460_em_848.lg, Incorrect,47,9,38,26,12,0.350141867281,18,306,11,32,6,0,0,0,12,11,0,6,6,6,0,0,0,0,0,0,0,0
./data/output_files/out/UN_460_em_849.lg, Incorrect,83,21,62,40,22,0.402321223189,28,756,17,49,11,0,4,2,18,19,0,8,6,12,0,0,0,0,0,0,0,0
./data/output_files/out/UN_461_em_850.lg, Incorrect,28,7,21,17,4,0.270297327838,17,272,12,19,2,0,0,0,13,14,0,10,8,5,0,0,0,0,0,0,0,0
./data/output_files/out/UN_461_em_851.lg, Incorrect,6,1,5,5,0,0.233333333333,5,20,3,5,0,4,0,0,4,4,0,4,3,1,0,0,0,1,0,0,0,0
./data/output_files/out/UN_461_em_852.lg, Incorrect,71,7,64,48,16,0.193798561686,33,1056,21,55,8,0,2,1,22,20,0,16,16,6,0,0,0,0,0,0,0,0
./data/output_files/out/UN_461_em_853.lg, Incorrect,32,4,28,26,2,0.260925013221,14,182,6,26,1,0,2,1,7,7,0,6,5,2,0,0,0,0,0,0,0,0
./data/output_files/out/UN_461_em_854.lg, Incorrect,156,35,121,81,40,0.427152645851,41,1640,23,86,20,0,30,15,24,23,0,10,6,18,0,0,0,0,0,0,0,0
./data/output_files/out/UN_461_em_855.lg, Incorrect,8,0,8,8,0,0.172132593165,6,30,2,8,0,6,0,0,3,3,0,3,3,0,0,0,0,1,1,0,0,0
./data/output_files/out/UN_461_em_856.lg, Incorrect,58,13,45,31,14,0.328814100448,24,552,15,37,7,0,2,1,16,13,0,8,8,8,0,0,0,0,0,0,0,0
./data/output_files/out/UN_461_em_857.lg, Incorrect,4,0,4,4,0,0.19245008973,4,12,2,4,0,4,0,0,3,3,0,3,3,0,0,0,0,1,1,0,0,0
./data/output_files/out/UN_461_em_858.lg, Incorrect,11,4,7,3,4,0.780370961672,4,12,2,5,2,0,0,0,3,1,0,0,0,3,0,0,0,0,0,0,0,0
./data/output_files/out/UN_461_em_859.lg, Incorrect,27,8,19,13,6,0.35869997252,14,182,13,16,3,0,0,0,14,8,0,7,6,8,0,0,0,0,0,0,0,0
./data/output_files/out/UN_461_em_860.lg, Incorrect,93,14,79,51,28,0.413020024746,23,506,9,63,14,0,4,2,10,14,0,6,5,5,0,0,0,0,0,0,0,0
./data/output_files/out/UN_461_em_861.lg, Incorrect,51,15,36,22,14,0.346544157848,24,552,19,29,7,9,0,0,20,17,0,9,6,14,0,0,0,0,0,0,0,0
./data/output_files/out/UN_461_em_862.lg, Incorrect,46,12,34,32,2,0.230691849551,28,756,22,33,1,0,0,0,23,16,0,16,12,11,0,0,0,0,0,0,0,0
./data/output_files/out/UN_461_em_863.lg, Incorrect,74,15,59,33,26,0.333508134139,28,756,20,45,13,0,2,1,21,14,0,8,8,13,0,0,0,0,0,0,0,0
./data/output_files/out/UN_461_em_864.lg, Incorrect,26,5,21,19,2,0.206863800707,18,306,14,20,1,0,0,0,15,12,0,11,10,5,0,0,0,0,0,0,0,0
./data/output_files/out/UN_461_em_865.lg, Incorrect,46,7,39,29,10,0.348245677549,16,240,8,33,5,0,2,1,9,11,0,7,6,3,0,0,0,0,0,0,0,0
./data/output_files/out/UN_461_em_866.lg, Incorrect,22,2,20,18,2,0.193060799532,14,182,8,19,1,0,0,0,9,8,0,8,8,1,0,0,0,0,0,0,0,0
./data/output_files/out/UN_461_em_867.lg, Incorrect,15,3,12,10,2,0.393770600877,7,42,4,11,1,0,0,0,4,4,0,2,2,2,0,0,0,0,0,0,0,0
./data/output_files/out/UN_461_em_868.lg, Incorrect,29,5,24,22,2,0.322053196786,12,132,6,23,1,0,0,0,7,6,0,4,3,4,0,0,0,0,0,0,0,0
./data/output_files/out/UN_461_em_869.lg, Incorrect,6,0,6,6,0,0.182574185835,5,20,2,6,0,5,0,0,3,3,0,3,3,0,0,0,0,1,1,0,0,0
./data/output_files/out/UN_461_em_870.lg, Incorrect,28,4,24,20,4,0.375738763391,10,90,3,21,2,0,2,1,4,4,0,3,2,2,0,0,0,0,0,0,0,0
./data/output_files/out/UN_461_em_871.lg, Incorrect,32,7,25,17,8,0.335626486976,15,210,8,21,4,0,0,0,9,7,0,5,5,4,0,0,0,0,0,0,0,0
./data/output_files/out/UN_461_em_872.lg, Incorrect,77,19,58,52,6,0.27821151205,35,1190,25,52,3,0,6,3,26,21,0,17,12,14,0,0,0,0,0,0,0,0
./data/output_files/out/UN_461_em_873.lg, Incorrect,91,16,75,49,26,0.385022575209,26,650,15,59,13,0,6,3,16,18,0,11,8,8,0,0,0,0,0,0,0,0
./data/output_files/out/UN_461_em_874.lg, Incorrect,59,11,48,40,8,0.24923411939,28,756,20,43,4,0,2,1,21,18,0,16,13,8,0,0,0,0,0,0,0,0
./data/output_files/out/UN_462_em_875.lg, Incorrect,14,2,12,12,0,0.210156837562,9,72,5,12,0,0,0,0,6,4,0,4,4,2,0,0,0,0,0,0,0,0
./data/output_files/out/UN_462_em_876.lg, Incorrect,15,3,12,10,2,0.342297428797,8,56,4,11,1,0,0,0,5,4,0,3,3,2,0,0,0,0,0,0,0,0
./data/output_files/out/UN_462_em_877.lg, Incorrect,37,3,34,30,4,0.152769149042,24,552,17,32,2,0,0,0,18,17,0,16,15,3,0,0,0,0,0,0,0,0
./data/output_files/out/UN_462_em_878.lg, Incorrect,10,4,6,6,0,0.569035593729,4,12,2,5,0,0,2,1,3,3,0,3,0,3,0,0,0,1,0,0,0,0
./data/output_files/out/UN_462_em_879.lg, Incorrect,9,3,6,4,2,0.487983441174,5,20,3,5,1,0,0,0,4,4,0,3,2,2,0,0,0,0,0,0,0,0
./data/output_files/out/UN_462_em_880.lg, Incorrect,45,4,41,35,6,0.154941200166,28,756,22,38,3,0,0,0,23,23,0,21,20,3,0,0,0,0,0,0,0,0
./data/output_files/out/UN_462_em_881.lg, Incorrect,11,3,8,2,6,0.757867787371,4,12,3,5,3,1,0,0,4,2,0,1,1,3,0,0,0,0,0,0,0,0
./data/output_files/out/UN_462_em_882.lg, Incorrect,7,1,6,6,0,0.204626754056,6,30,4,6,0,0,0,0,5,4,0,4,4,1,0,0,0,0,0,0,0,0
./data/output_files/out/UN_462_em_883.lg, Incorrect,21,4,17,11,6,0.364270794476,10,90,7,14,3,0,0,0,8,9,0,7,6,2,0,0,0,0,0,0,0,0
./data/output_files/out/UN_462_em_884.lg, Incorrect,9,3,6,6,0,0.315737865167,6,30,4,6,0,3,0,0,5,5,0,5,2,3,0,0,0,1,0,0,0,0
./data/output_files/out/UN_462_em_885.lg, Incorrect,29,7,22,22,0,0.187400729147,21,420,18,22,0,0,0,0,19,16,0,16,12,7,0,0,0,0,0,0,0,0
./data/output_files/out/UN_462_em_886.lg, Incorrect,22,4,18,14,4,0.444735983809,8,56,4,15,2,0,2,1,5,5,0,4,3,2,0,0,0,0,0,0,0,0
./data/output_files/out/UN_462_em_887.lg, Incorrect,20,5,15,11,4,0.635196162063,6,30,3,12,2,0,2,1,4,3,0,1,1,3,0,0,0,0,0,0,0,0
./data/output_files/out/UN_462_em_888.lg, Incorrect,11,1,10,10,0,0.144444444444,10,90,8,10,0,0,0,0,9,8,0,8,8,1,0,0,0,0,0,0,0,0
./data/output_files/out/UN_462_em_889.lg, Incorrect,11,3,8,8,0,0.222222222222,9,72,8,8,0,0,0,0,9,7,0,7,6,3,0,0,0,0,0,0,0,0
./data/output_files/out/UN_462_em_890.lg, Incorrect,9,3,6,6,0,0.315737865167,6,30,6,6,0,0,0,0,6,4,0,4,3,3,0,0,0,0,0,0,0,0
./data/output_files/out/UN_462_em_891.lg, Incorrect,29,5,24,18,6,0.300615878848,14,182,8,21,3,0,0,0,9,7,0,7,6,3,0,0,0,0,0,0,0,0
./data/output_files/out/UN_462_em_892.lg, Incorrect,24,4,20,10,10,0.401579284708,10,90,7,14,5,6,2,1,8,6,0,5,5,3,0,0,0,0,0,0,0,0
./data/output_files/out/UN_462_em_893.lg, Incorrect,28,8,20,12,8,0.474451368323,11,110,7,15,4,0,2,1,8,7,0,4,2,6,0,0,0,0,0,0,0,0
./data/output_files/out/UN_462_em_894.lg, Incorrect,25,8,17,13,4,0.399871534635,12,132,9,15,2,0,0,0,10,8,0,6,4,6,0,0,0,0,0,0,0,0
./data/output_files/out/UN_462_em_895.lg, Incorrect,9,3,6,4,2,0.621785023883,4,12,2,5,1,0,0,0,3,3,0,1,1,2,0,0,0,0,0,0,0,0
./data/output_files/out/UN_462_em_896.lg, Incorrect,23,6,17,17,0,0.228173772992,15,210,11,17,0,0,0,0,12,9,0,9,6,6,0,0,0,0,0,0,0,0
./data/output_files/out/UN_462_em_897.lg, Incorrect,24,4,20,18,2,0.259659149375,13,156,8,19,1,9,0,0,9,10,0,8,6,3,0,0,0,0,0,0,0,0
./data/output_files/out/UN_462_em_898.lg, Incorrect,12,1,11,11,0,0.167326363699,9,72,6,11,0,0,0,0,7,6,0,6,6,1,0,0,0,0,0,0,0,0
./data/output_files/out/UN_462_em_899.lg, Incorrect,3,1,2,2,0,0.303561200841,3,6,2,2,0,2,0,0,3,3,0,3,2,1,0,0,0,1,0,0,0,0
./data/output_files/out/UN_463_em_900.lg, Incorrect,13,2,11,11,0,0.18320098313,10,90,7,11,0,0,0,0,8,6,0,6,6,2,0,0,0,0,0,0,0,0
./data/output_files/out/UN_463_em_901.lg, Incorrect,43,9,34,22,12,0.387497708035,16,240,12,27,6,0,2,1,12,13,0,8,7,5,0,0,0,0,0,0,0,0
./data/output_files/out/UN_463_em_902.lg, Incorrect,2,0,2,2,0,0.19245008973,3,6,2,2,0,3,0,0,3,3,0,3,3,0,0,0,0,1,1,0,0,0
./data/output_files/out/UN_463_em_903.lg, Incorrect,27,7,20,16,4,0.38222015379,12,132,6,16,2,0,4,2,7,7,0,5,3,4,0,0,0,0,0,0,0,0
./data/output_files/out/UN_463_em_904.lg, Incorrect,61,5,56,52,4,0.174492084098,28,756,18,54,2,0,0,0,18,16,0,14,13,5,0,0,0,0,0,0,0,0
./data/output_files/out/UN_463_em_905.lg, Incorrect,48,12,36,26,10,0.273637519431,26,650,21,31,5,0,0,0,22,18,0,14,12,10,0,0,0,0,0,0,0,0
./data/output_files/out/UN_463_em_906.lg, Incorrect,12,3,9,7,2,0.369899789565,7,42,5,8,1,0,0,0,6,6,0,5,4,2,0,0,0,0,0,0,0,0
./data/output_files/out/UN_463_em_907.lg, Incorrect,55,4,51,43,8,0.20570906128,23,506,15,46,4,0,2,1,15,14,0,13,12,3,0,0,0,0,0,0,0,0
./data/output_files/out/UN_463_em_908.lg, Incorrect,35,8,27,19,8,0.690776515946,8,56,2,19,4,0,8,4,3,3,0,1,0,3,0,0,0,0,0,0,0,0
./data/output_files/out/UN_463_em_909.lg, Incorrect,14,1,13,13,0,0.17867646797,9,72,5,13,0,8,0,0,6,6,0,6,5,1,0,0,0,1,0,0,0,0
./data/output_files/out/UN_463_em_910.lg, Incorrect,25,3,22,22,0,0.130204417198,20,380,16,22,0,0,0,0,17,16,0,16,14,3,0,0,0,0,0,0,0,0
./data/output_files/out/UN_463_em_911.lg, Incorrect,61,10,51,39,12,0.289356000753,24,552,14,44,6,14,2,1,15,17,0,11,9,6,0,0,0,0,0,0,0,0
./data/output_files/out/UN_463_em_912.lg, Incorrect,45,9,36,30,6,0.234982991426,25,600,17,33,3,0,0,0,19,19,0,15,13,6,0,0,0,0,0,0,0,0
./data/output_files/out/UN_463_em_913.lg, Incorrect,157,31,126,92,34,0.272329545322,59,3422,41,107,17,0,4,2,42,40,0,27,21,21,0,0,0,0,0,0,0,0
./data/output_files/out/UN_463_em_914.lg, Incorrect,46,6,40,40,0,0.180676781258,23,506,14,40,0,0,0,0,16,15,0,15,10,6,0,0,0,0,0,0,0,0
./data/output_files/out/UN_463_em_915.lg, Incorrect,42,8,34,28,6,0.238645539336,23,506,14,31,3,0,0,0,15,15,0,11,8,7,0,0,0,0,0,0,0,0
./data/output_files/out/UN_463_em_916.lg, Incorrect,28,2,26,24,2,0.181809129073,16,240,8,25,1,0,0,0,9,9,0,8,8,1,0,0,0,0,0,0,0,0
./data/output_files/out/UN_463_em_917.lg, Incorrect,3,1,2,2,0,0.303561200841,3,6,2,2,0,0,0,0,3,2,0,2,2,1,0,0,0,0,0,0,0,0
./data/output_files/out/UN_463_em_918.lg, Incorrect,15,3,12,12,0,0.201005467422,11,110,7,12,0,0,0,0,8,7,0,7,5,3,0,0,0,0,0,0,0,0
./data/output_files/out/UN_463_em_919.lg, Incorrect,10,1,9,9,0,0.175297287623,8,56,5,9,0,0,0,0,6,5,0,5,5,1,0,0,0,0,0,0,0,0
./data/output_files/out/UN_463_em_920.lg, Incorrect,16,5,11,7,4,0.445154624042,8,56,6,9,2,0,0,0,7,5,0,4,3,4,0,0,0,0,0,0,0,0
./data/output_files/out/UN_463_em_921.lg, Incorrect,20,5,15,11,4,0.373022267047,10,90,6,13,2,0,0,0,7,5,0,3,3,4,0,0,0,0,0,0,0,0
./data/output_files/out/UN_463_em_922.lg, Incorrect,14,2,12,12,0,0.170702437119,11,110,8,12,0,0,0,0,9,8,0,8,7,2,0,0,0,0,0,0,0,0
./data/output_files/out/UN_463_em_923.lg, Incorrect,58,12,46,28,18,0.409247028017,19,342,12,35,9,0,4,2,13,15,0,11,6,7,0,0,0,0,0,0,0,0
./data/output_files/out/UN_463_em_924.lg, Incorrect,36,5,31,21,10,0.27448473224,17,272,10,26,5,12,0,0,11,13,0,9,8,3,0,0,0,0,0,0,0,0
./data/output_files/out/UN_464_em_925.lg, Incorrect,15,3,12,8,4,0.607270088247,5,20,2,9,2,0,2,1,3,3,0,2,2,1,0,0,0,0,0,0,0,0
./data/output_files/out/UN_464_em_926.lg, Incorrect,39,8,31,17,14,0.420496274156,14,182,7,24,7,6,0,0,8,10,0,5,3,5,0,0,0,0,0,0,0,0
./data/output_files/out/UN_464_em_927.lg, Incorrect,14,2,12,12,0,0.170702437119,11,110,8,12,0,9,0,0,9,9,0,9,7,2,0,0,0,1,0,0,0,0
./data/output_files/out/UN_464_em_928.lg, Incorrect,19,6,13,7,6,0.46008669802,9,72,6,10,3,0,0,0,7,7,0,3,3,4,0,0,0,0,0,0,0,0
./data/output_files/out/UN_464_em_929.lg, Incorrect,23,2,21,21,0,0.12435984237,18,306,13,21,0,16,0,0,14,14,0,14,12,2,0,0,0,1,0,0,0,0
./data/output_files/out/UN_464_em_930.lg, Incorrect,22,3,19,15,4,0.408247871474,8,56,3,16,2,0,2,1,4,4,0,3,3,1,0,0,0,0,0,0,0,0
./data/output_files/out/UN_464_em_931.lg, Incorrect,21,3,18,18,0,0.153787092918,16,240,12,18,0,0,0,0,13,12,0,12,10,3,0,0,0,0,0,0,0,0
./data/output_files/out/UN_464_em_932.lg, Incorrect,24,5,19,15,4,0.257379682987,15,210,9,17,2,10,0,0,10,10,0,7,5,5,0,0,0,0,0,0,0,0
./data/output_files/out/UN_464_em_933.lg, Incorrect,4,1,3,3,0,0.25,4,12,2,3,0,0,0,0,3,2,0,2,2,1,0,0,0,0,0,0,0,0
./data/output_files/out/UN_464_em_934.lg, Incorrect,7,0,7,7,0,0.136082763488,7,42,3,7,0,7,0,0,4,4,0,4,4,0,0,0,0,1,1,0,0,0
./data/output_files/out/UN_464_em_935.lg, Incorrect,40,12,28,14,14,0.508908408511,14,182,9,21,7,0,0,0,10,8,0,3,2,8,0,0,0,0,0,0,0,0
./data/output_files/out/UN_464_em_936.lg, Incorrect,11,4,7,7,0,0.284517796864,8,56,7,7,0,0,0,0,8,7,0,7,4,4,0,0,0,0,0,0,0,0
./data/output_files/out/UN_464_em_937.lg, Incorrect,21,6,15,11,4,0.452934797217,9,72,5,13,2,0,0,0,6,5,0,3,2,4,0,0,0,0,0,0,0,0
./data/output_files/out/UN_464_em_938.lg, Incorrect,22,6,16,16,0,0.241690385079,14,182,13,16,0,0,0,0,13,8,0,8,7,6,0,0,0,0,0,0,0,0
./data/output_files/out/UN_464_em_939.lg, Incorrect,24,4,20,18,2,0.240679847151,14,182,9,19,1,0,0,0,10,8,0,8,7,3,0,0,0,0,0,0,0,0
./data/output_files/out/UN_464_em_940.lg, Incorrect,43,14,29,25,4,0.265751200667,27,702,25,27,2,0,0,0,26,20,0,18,13,13,0,0,0,0,0,0,0,0
./data/output_files/out/UN_464_em_941.lg, Incorrect,84,15,69,57,12,0.218837002251,41,1640,28,63,6,0,0,0,29,29,0,22,20,9,0,0,0,0,0,0,0,0
./data/output_files/out/UN_464_em_942.lg, Incorrect,29,4,25,21,4,0.207461862518,18,306,14,23,2,14,0,0,15,17,0,13,13,2,0,0,0,0,0,0,0,0
./data/output_files/out/UN_464_em_943.lg, Incorrect,41,4,37,37,0,0.11713138394,29,812,20,37,0,0,0,0,21,20,0,20,17,4,0,0,0,0,0,0,0,0
./data/output_files/out/UN_464_em_944.lg, Incorrect,2,0,2,2,0,0.19245008973,3,6,2,2,0,3,0,0,3,3,0,3,3,0,0,0,0,1,1,0,0,0
./data/output_files/out/UN_464_em_945.lg, Incorrect,22,5,17,13,4,0.270339214409,14,182,11,15,2,9,0,0,12,10,0,8,6,6,0,0,0,0,0,0,0,0
./data/output_files/out/UN_464_em_946.lg, Incorrect,20,4,16,10,6,0.45394977306,8,56,4,13,3,0,0,0,5,5,0,4,3,2,0,0,0,0,0,0,0,0
./data/output_files/out/UN_464_em_947.lg, Incorrect,27,8,19,19,0,0.24496176841,17,272,13,19,0,0,0,0,14,10,0,10,6,8,0,0,0,0,0,0,0,0
./data/output_files/out/UN_464_em_948.lg, Incorrect,36,8,28,22,6,0.411720007797,13,156,7,25,3,0,0,0,8,9,0,4,3,5,0,0,0,0,0,0,0,0
./data/output_files/out/UN_464_em_949.lg, Incorrect,47,8,39,29,10,0.495154971484,12,132,5,33,5,4,2,1,6,9,0,4,2,4,0,0,0,0,0,0,0,0
./data/output_files/out/UN_465_em_950.lg, Incorrect,10,4,6,6,0,0.569035593729,4,12,2,5,0,0,2,1,3,2,0,2,0,3,0,0,0,0,0,0,0,0
./data/output_files/out/UN_465_em_951.lg, Incorrect,43,12,31,19,12,0.508876435192,14,182,8,25,6,0,0,0,9,8,0,2,1,8,0,0,0,0,0,0,0,0
./data/output_files/out/UN_465_em_952.lg, Incorrect,45,12,33,25,8,0.385583957357,18,306,11,29,4,0,0,0,12,11,0,7,4,8,0,0,0,0,0,0,0,0
./data/output_files/out/UN_465_em_953.lg, Incorrect,9,2,7,7,0,0.231320858726,7,42,5,7,0,0,0,0,6,4,0,4,4,2,0,0,0,0,0,0,0,0
./data/output_files/out/UN_465_em_954.lg, Incorrect,37,10,27,23,4,0.415900006959,14,182,8,22,2,0,6,3,9,9,0,7,4,5,0,0,0,0,0,0,0,0
./data/output_files/out/UN_465_em_955.lg, Incorrect,61,11,50,42,8,0.270455686812,26,650,16,45,4,0,2,1,17,19,0,13,11,6,0,0,0,0,0,0,0,0
./data/output_files/out/UN_465_em_956.lg, Incorrect,9,2,7,5,2,0.557336968763,4,12,3,6,1,2,0,0,3,4,0,2,1,2,0,0,0,0,0,0,0,0
./data/output_files/out/UN_465_em_957.lg, Incorrect,49,2,47,45,2,0.0989581195383,35,1190,24,46,1,0,0,0,25,25,0,24,24,1,0,0,0,0,0,0,0,0
./data/output_files/out/UN_465_em_958.lg, Incorrect,16,2,14,12,2,0.312994078835,8,56,3,13,1,6,0,0,4,5,0,3,3,1,0,0,0,0,0,0,0,0
./data/output_files/out/UN_465_em_959.lg, Incorrect,87,20,67,39,28,0.489561505732,23,506,13,51,14,0,4,2,14,11,0,4,2,12,0,0,0,0,0,0,0,0
./data/output_files/out/UN_465_em_960.lg, Incorrect,59,9,50,44,6,0.214816966446,29,812,18,46,3,0,2,1,19,18,0,15,14,5,0,0,0,0,0,0,0,0
./data/output_files/out/UN_465_em_961.lg, Incorrect,31,4,27,25,2,0.155926551959,23,506,18,26,1,0,0,0,19,19,0,17,15,4,0,0,0,0,0,0,0,0
./data/output_files/out/UN_465_em_962.lg, Incorrect,7,2,5,3,2,0.517915171611,4,12,2,4,1,0,0,0,3,3,0,2,2,1,0,0,0,0,0,0,0,0
./data/output_files/out/UN_465_em_963.lg, Incorrect,81,22,59,45,14,0.286941257782,39,1482,29,52,7,0,0,0,30,32,0,22,15,15,0,0,0,0,0,0,0,0
./data/output_files/out/UN_465_em_964.lg, Incorrect,15,2,13,11,2,0.306931430778,8,56,5,12,1,0,0,0,5,5,0,4,4,1,0,0,0,0,0,0,0,0
./data/output_files/out/UN_465_em_965.lg, Incorrect,15,5,10,6,4,0.718106792229,5,20,2,7,2,0,2,1,3,3,0,1,0,3,0,0,0,0,0,0,0,0
./data/output_files/out/UN_465_em_966.lg, Incorrect,97,17,80,54,26,0.27396316153,38,1406,24,66,13,0,2,1,25,23,0,16,16,9,0,0,0,0,0,0,0,0
./data/output_files/out/UN_465_em_967.lg, Incorrect,48,7,41,35,6,0.232631506781,23,506,14,37,3,0,2,1,15,15,0,11,9,6,0,0,0,0,0,0,0,0
./data/output_files/out/UN_465_em_968.lg, Incorrect,88,19,69,43,26,0.293608626464,37,1332,29,56,13,0,0,0,30,24,0,22,18,12,0,0,0,0,0,0,0,0
./data/output_files/out/UN_465_em_969.lg, Incorrect,22,6,16,8,8,0.748898174278,6,30,2,11,4,0,2,1,3,3,0,0,0,3,0,0,0,0,0,0,0,0
./data/output_files/out/UN_465_em_970.lg, Incorrect,47,8,39,33,6,0.22498365856,25,600,17,36,3,0,0,0,18,18,0,13,12,6,0,0,0,0,0,0,0,0
./data/output_files/out/UN_465_em_971.lg, Incorrect,32,4,28,20,8,0.319268995796,13,156,7,24,4,0,0,0,7,6,0,4,4,3,0,0,0,0,0,0,0,0
./data/output_files/out/UN_465_em_972.lg, Incorrect,5,2,3,3,0,0.333333333333,4,12,3,3,0,0,0,0,4,3,0,3,2,2,0,0,0,0,0,0,0,0
./data/output_files/out/UN_465_em_973.lg, Incorrect,10,2,8,6,2,0.369310000858,6,30,3,7,1,0,0,0,4,4,0,3,3,1,0,0,0,0,0,0,0,0
./data/output_files/out/UN_465_em_974.lg, Incorrect,26,3,23,21,2,0.196118895534,16,240,9,22,1,0,0,0,10,10,0,8,7,3,0,0,0,0,0,0,0,0
./data/output_files/out/UN_466_em_976.lg, Incorrect,16,4,12,8,4,0.55475685679,6,30,3,10,2,0,0,0,4,5,0,2,2,2,0,0,0,0,0,0,0,0
./data/output_files/out/UN_466_em_977.lg, Incorrect,40,8,32,24,8,0.293294699773,19,342,11,28,4,0,0,0,12,12,0,10,7,5,0,0,0,0,0,0,0,0
./data/output_files/out/UN_466_em_978.lg, Incorrect,32,7,25,19,6,0.326910099095,15,210,8,22,3,0,0,0,9,6,0,6,5,4,0,0,0,0,0,0,0,0
./data/output_files/out/UN_466_em_979.lg, Incorrect,17,2,15,11,4,0.397311763435,7,42,3,13,2,0,0,0,4,4,0,2,2,2,0,0,0,0,0,0,0,0
./data/output_files/out/UN_466_em_980.lg, Incorrect,33,8,25,17,8,0.297321945458,18,306,15,21,4,0,0,0,16,13,0,11,8,8,0,0,0,0,0,0,0,0
./data/output_files/out/UN_466_em_981.lg, Incorrect,29,11,18,18,0,0.269454367431,19,342,18,18,0,0,0,0,19,14,0,14,8,11,0,0,0,0,0,0,0,0
./data/output_files/out/UN_466_em_982.lg, Incorrect,20,6,14,10,4,0.682759474245,6,30,2,11,2,0,2,1,3,3,0,1,0,3,0,0,0,0,0,0,0,0
./data/output_files/out/UN_466_em_983.lg, Incorrect,76,17,59,33,26,0.435759360143,23,506,16,45,13,0,2,1,16,14,0,5,4,12,0,0,0,0,0,0,0,0
./data/output_files/out/UN_466_em_984.lg, Incorrect,20,6,14,12,2,0.381158839124,10,90,7,13,1,0,0,0,8,6,0,5,3,5,0,0,0,0,0,0,0,0
./data/output_files/out/UN_466_em_985.lg, Incorrect,53,16,37,31,6,0.343274480048,24,552,18,32,3,0,4,2,19,16,0,13,7,12,0,0,0,0,0,0,0,0
./data/output_files/out/UN_466_em_986.lg, Incorrect,51,8,43,29,14,0.309444157514,20,380,11,36,7,0,0,0,12,12,0,8,8,4,0,0,0,0,0,0,0,0
./data/output_files/out/UN_466_em_987.lg, Incorrect,64,7,57,49,8,0.279913548003,21,420,11,52,4,14,2,1,12,13,0,9,8,4,0,0,0,0,0,0,0,0
./data/output_files/out/UN_466_em_988.lg, Incorrect,49,11,38,18,20,0.331619029817,22,462,19,28,10,0,0,0,20,15,0,11,9,11,0,0,0,0,0,0,0,0
./data/output_files/out/UN_466_em_989.lg, Incorrect,60,16,44,34,10,0.288477603124,30,870,22,37,5,0,4,2,23,21,0,17,11,12,0,0,0,0,0,0,0,0
./data/output_files/out/UN_466_em_990.lg, Incorrect,39,5,34,34,0,0.146015871428,25,600,18,34,0,0,0,0,19,18,0,18,14,5,0,0,0,0,0,0,0,0
./data/output_files/out/UN_466_em_991.lg, Incorrect,75,14,61,27,34,0.491491268948,19,342,10,42,17,0,4,2,11,11,0,6,4,7,0,0,0,0,0,0,0,0
./data/output_files/out/UN_466_em_992.lg, Incorrect,25,9,16,16,0,0.292008741246,15,210,12,16,0,0,0,0,13,12,0,12,4,9,0,0,0,0,0,0,0,0
./data/output_files/out/UN_466_em_993.lg, Incorrect,29,8,21,17,4,0.308301144676,16,240,12,19,2,0,0,0,13,10,0,7,6,7,0,0,0,0,0,0,0,0
./data/output_files/out/UN_466_em_994.lg, Incorrect,9,3,6,4,2,0.621785023883,4,12,2,5,1,0,0,0,3,3,0,2,1,2,0,0,0,0,0,0,0,0
./data/output_files/out/UN_466_em_995.lg, Incorrect,29,5,24,18,6,0.280141962057,15,210,9,21,3,0,0,0,10,7,0,7,7,3,0,0,0,0,0,0,0,0
./data/output_files/out/UN_466_em_996.lg, Incorrect,19,5,14,12,2,0.437994078835,8,56,6,13,1,0,0,0,6,6,0,4,2,4,0,0,0,0,0,0,0,0
./data/output_files/out/UN_466_em_997.lg, Incorrect,3,1,2,2,0,0.303561200841,3,6,2,2,0,2,0,0,3,3,0,3,2,1,0,0,0,1,0,0,0,0
./data/output_files/out/UN_466_em_998.lg, Incorrect,18,4,14,10,4,0.571648363134,6,30,2,11,2,2,2,1,3,4,0,2,1,2,0,0,0,0,0,0,0,0
./data/output_files/out/UN_466_em_999.lg, Incorrect,10,3,7,3,4,0.697037628339,4,12,2,5,2,1,0,0,3,3,0,1,1,2,0,0,0,0,0,0,0,0
